TTCTCACGTGTTCGAGATC :  TCTCACGTGTTCGAGATCA
CCTCGCGCGACTCACGTTA :  CTCGCGCGACTCACGTTAA
CGCACCCGCGCCTCCCCCT :  GCACCCGCGCCTCCCCCTC
GAGATGGGATCGGTAGAAT :  AGATGGGATCGGTAGAATA
ACGAGTTGTAGTCAAGAGA :  CGAGTTGTAGTCAAGAGAG
GCTAATCGCGTTTAACGGC :  CTAATCGCGTTTAACGGCT
GCCTTTTGTAGTTCACCCT :  CCTTTTGTAGTTCACCCTA
TTGTGGGACCTTTAACCCC :  TGTGGGACCTTTAACCCCC
GTGGAATTTGGAACGAGAA :  TGGAATTTGGAACGAGAAA TGGAATTTGGAACGAGAAT
AGCTTGAGTGTATTTTTTT :  GCTTGAGTGTATTTTTTTC
AAGCACGGGTAGCGGGGGA :  AGCACGGGTAGCGGGGGAC
ATCCCTCGCGCGACTCACG :  TCCCTCGCGCGACTCACGT
CGTGTTAGAGAACTGCATG :  GTGTTAGAGAACTGCATGA
TAGAAGGTGGCTCGTCGGC :  AGAAGGTGGCTCGTCGGCG
AATGGTCATACTCAGCTTG :  ATGGTCATACTCAGCTTGA
CGTTTAGTGGCGGATTGAG :  GTTTAGTGGCGGATTGAGC
GGTACGAAAGACACTGTCT :  GTACGAAAGACACTGTCTG
GGTGATAATAAGCACGGGT :  GTGATAATAAGCACGGGTA
TGCTTAAGAGCGCCCGTAC :  GCTTAAGAGCGCCCGTACT
AGCCATCCAGTGGAATTTG :  GCCATCCAGTGGAATTTGG
CGGTGTATGATTAACTCAC :  GGTGTATGATTAACTCACG
CAAGTTCTGTACCTACCAG :  AAGTTCTGTACCTACCAGT
GTAGTCCAATACGTATGGT :  TAGTCCAATACGTATGGTT
CCCTTCGCATCGACTGATT :  CCTTCGCATCGACTGATTA
GTTTCAAAGGATCGCTGTT :  TTTCAAAGGATCGCTGTTC
GTGTGCAGCGAGTGTGTAT :  TGTGCAGCGAGTGTGTATC
GTGCGAGGTGTGCAGCGAG :  TGCGAGGTGTGCAGCGAGT
GTCCACGCCGTTGACCGTG :  TCCACGCCGTTGACCGTGT
GGGGCAAACGTCATATCCG :  GGGCAAACGTCATATCCGG
CCCCGACGTTGGCGAAGGG :  CCCGACGTTGGCGAAGGGT
GTAGAATAACTCCCACGTG :  TAGAATAACTCCCACGTGT
GTTTATACGCCGATGAGGT :  TTTATACGCCGATGAGGTG
AGTGGAATTTGGAACGAAT :  GTGGAATTTGGAACGAATC
CTCGGCCAACCAAAAGCTG :  TCGGCCAACCAAAAGCTGT
ACTCGGTACGAAAGACACT :  CTCGGTACGAAAGACACTG
TCTAGACCGTTGAACCGGA :  CTAGACCGTTGAACCGGAT
GAACTGCATGACTGCGTTT :  AACTGCATGACTGCGTTTA
AGCCGCACCCGCGCCTCCC :  GCCGCACCCGCGCCTCCCC
CACTCGGTACGAAAGACAC :  ACTCGGTACGAAAGACACT
GCGAAGTAATAAAAAAGAC :  CGAAGTAATAAAAAAGACG
GGATCGGTAGAATAACTCC :  GATCGGTAGAATAACTCCC
TAGAAGCTCTCAAAGCCGC :  AGAAGCTCTCAAAGCCGCA
TTCGCATCGACTGATTAGC :  TCGCATCGACTGATTAGCT
GCTGTTTATACGCCGATGA :  CTGTTTATACGCCGATGAG
TATTTTTTTCAAGGTTGGC :  ATTTTTTTCAAGGTTGGCC
TAGACCCCTGACCACGACC :  AGACCCCTGACCACGACCA
AACGCTGCATCATAGTGAG :  ACGCTGCATCATAGTGAGG
GGCAAGTTTCATGTCTAGG :  GCAAGTTTCATGTCTAGGC
CTCAGTCACACCGTGCCAA :  TCAGTCACACCGTGCCAAT
GAGGTGCTTAAGAGCGCCC :  AGGTGCTTAAGAGCGCCCG
ACGTCATATCCGGTGCATG :  CGTCATATCCGGTGCATGA
GACAATGGCCTGAACTGGT :  ACAATGGCCTGAACTGGTA
TCTTGAGTTGAAGTGGACA :  CTTGAGTTGAAGTGGACAC
GTGTCTCGCGTACAAGCAG :  TGTCTCGCGTACAAGCAGG
GCACCTTGACGAGACCGTG :  CACCTTGACGAGACCGTGG
TGGTACTGCTGGCCGTGGC :  GGTACTGCTGGCCGTGGCA
TCCGCCCGCAAGATGTCCA :  CCGCCCGCAAGATGTCCAC
GTCACACCGTGCCAATGAT :  TCACACCGTGCCAATGATT
TGACTACCACTTGTGGGAC :  GACTACCACTTGTGGGACC
ATTTGAGGTGGATTCAGTG :  TTTGAGGTGGATTCAGTGC
AAAGTAGACCCCTGACCAC :  AAGTAGACCCCTGACCACG
ATGCCTCGGCCAACCAAAA :  TGCCTCGGCCAACCAAAAG
CAGAAGGCATAAACTCCCC :  AGAAGGCATAAACTCCCCG
TCCTGTTAAAAAGCCCGTG :  CCTGTTAAAAAGCCCGTGA
GGTATCGCCTGGTCTTGCA :  GTATCGCCTGGTCTTGCAG
ACGAGAAAGAGTGCCCAGT :  CGAGAAAGAGTGCCCAGTG
CTGGCCGTGGCATTAGTTG :  TGGCCGTGGCATTAGTTGT
CCGGAAATGGCTCGGCCTT :  CGGAAATGGCTCGGCCTTT
TGCAGCGAGTGTGTATCGT :  GCAGCGAGTGTGTATCGTT
AATCATCGCCCAATCGCGT :  ATCATCGCCCAATCGCGTA
ATGATTACATCAATAAGTG :  TGATTACATCAATAAGTGG
CCTGAACTGGTACTGCTGG :  CTGAACTGGTACTGCTGGC
AGAGGTTGTCCGTGAGCCG :  GAGGTTGTCCGTGAGCCGC
GCAGCTCGGTCTCCATGCC :  CAGCTCGGTCTCCATGCCC
CCATTTTCACACCAATTCC :  CATTTTCACACCAATTCCG
CCCGACGTTGGCGAAGGGT :  CCGACGTTGGCGAAGGGTC
TATCCGGTGCATGACAATG :  ATCCGGTGCATGACAATGC
GTCGAAGTTATAGAGTCAG :  TCGAAGTTATAGAGTCAGG
CTGAACTGGTACTGCTGGC :  TGAACTGGTACTGCTGGCC
ACCGGGGACACATACTAGG :  CCGGGGACACATACTAGGA
TTATCTAGACCGTTGAACC :  TATCTAGACCGTTGAACCG
AGAGCCCGATCCAAGACAA :  GAGCCCGATCCAAGACAAT
CAAATAATCAGGTGTTAGA :  AAATAATCAGGTGTTAGAT
ATCAGGAGTGACCTAATGC :  TCAGGAGTGACCTAATGCG
GTGGAATTTGGAACGAATC :  TGGAATTTGGAACGAATCC
GATTGTGCGGTGTATGATT :  ATTGTGCGGTGTATGATTA
GTGAGCCGCCGATGAAGGC :  TGAGCCGCCGATGAAGGCT
GGTAGAATAACTCCCACGT :  GTAGAATAACTCCCACGTG
TACGTATGGTTCAGACACC :  ACGTATGGTTCAGACACCT
CCGGTATACGCGCCAGTGG :  CGGTATACGCGCCAGTGGA
AGTATTCGCCGGAAATGGC :  GTATTCGCCGGAAATGGCT
GAGTGCCCAGTGACAAGCC :  AGTGCCCAGTGACAAGCCT
GACAAGCCTCAGAGCATTA :  ACAAGCCTCAGAGCATTAG
CGATCCAAGACAATGGCCT :  GATCCAAGACAATGGCCTG
AGCTTAGGAGTAGGTATCC :  GCTTAGGAGTAGGTATCCA
CAGGCACCTTGACGAGACC :  AGGCACCTTGACGAGACCG
CTGTTTGTTGAGGTGCTTA :  TGTTTGTTGAGGTGCTTAA
TCAAAGGATCGCTGTTCGG :  CAAAGGATCGCTGTTCGGC
ATGGTTCAGACACCTCAGT :  TGGTTCAGACACCTCAGTC
TGACAAGCCTCAGAGCATT :  GACAAGCCTCAGAGCATTA
TCACACCGTGCCAATGATT :  CACACCGTGCCAATGATTG
CTCACAAGTTCTGTACCTA :  TCACAAGTTCTGTACCTAC
CCCGGGCGGCGGGCAACCT :  CCGGGCGGCGGGCAACCTG
TACAATTTCGTTCTCACGT :  ACAATTTCGTTCTCACGTG
CCCGTACTACGAGTTGTAG :  CCGTACTACGAGTTGTAGT
CGGGCTCAAGAGAGCGCAG :  GGGCTCAAGAGAGCGCAGC
TCTGTACCTACCAGTTGCG :  CTGTACCTACCAGTTGCGC
AATTCAGGGGCACCCGCTA :  ATTCAGGGGCACCCGCTAA
GCATCATAGTGAGGGGGCT :  CATCATAGTGAGGGGGCTC
TCATCGCCCAATCGCGTAG :  CATCGCCCAATCGCGTAGA
CCCGGTATACGCGCCAGTG :  CCGGTATACGCGCCAGTGG
CGGGGACACATACTAGGAC :  GGGGACACATACTAGGACA
GGAACGAATCCTCCAGGTG :  GAACGAATCCTCCAGGTGG
GATAGTCGAAGTTATAGAG :  ATAGTCGAAGTTATAGAGT
GGGGACCAGAAGGCATAAA :  GGGACCAGAAGGCATAAAC
CACCCGATGACCGGGGACA :  ACCCGATGACCGGGGACAC
GGTGTATGATTAACTCACG :  GTGTATGATTAACTCACGA
TTGTCAATATTCAGCGAAA :  TGTCAATATTCAGCGAAAT
AGAGAGCGCAGCGCGCAGG :  GAGAGCGCAGCGCGCAGGT
TCAACTGCTCGATCCTGTT :  CAACTGCTCGATCCTGTTA
CATGTCTAGGCGCTGGCTA :  ATGTCTAGGCGCTGGCTAT
AAGGATCCGCAATCATCGC :  AGGATCCGCAATCATCGCC
TGAAGGCTTGCCTCGGTGT :  GAAGGCTTGCCTCGGTGTC
ATTTGGAACGATCATTGCA :  TTTGGAACGATCATTGCAT
GAAGTAATAAAAAAGACGT :  AAGTAATAAAAAAGACGTG
TGGATTCAGTGCAATGGTG :  GGATTCAGTGCAATGGTGA
GCGCTAAGGATCCGCAATC :  CGCTAAGGATCCGCAATCA
TGGTCTTGCAGTTGTCAAT :  GGTCTTGCAGTTGTCAATA
TCCCACGTGTTATCAATGC :  CCCACGTGTTATCAATGCC
CAGGTGGCAGCTCGGTCTC :  AGGTGGCAGCTCGGTCTCC
GGCCAGGCTTAACTTGACT :  GCCAGGCTTAACTTGACTA
GGGCTCAAGAGAGCGCAGC :  GGCTCAAGAGAGCGCAGCG
CGCATCGACTGATTAGCTG :  GCATCGACTGATTAGCTGT
CGTGGTATCGCCTGGTCTT :  GTGGTATCGCCTGGTCTTG
GGATTCACACGGTGCGTGA :  GATTCACACGGTGCGTGAT
AGAGTGCCCAGTGACAAGC :  GAGTGCCCAGTGACAAGCC
CCGGATCGTTAAAGGGGCT :  CGGATCGTTAAAGGGGCTA
CAGGGCAATGGTGCACACC :  AGGGCAATGGTGCACACCC
AAAGCCGCACCCGCGCCTC :  AAGCCGCACCCGCGCCTCC
GTGGCCTTATCTAGACCGT :  TGGCCTTATCTAGACCGTT
AAGTTATAGAGTCAGGGGG :  AGTTATAGAGTCAGGGGGC
ACGCCGTTGACCGTGTTAG :  CGCCGTTGACCGTGTTAGA
TTTCAAGGTTGGCCAAATA :  TTCAAGGTTGGCCAAATAA
CAGTGCAATGGTGATAATA :  AGTGCAATGGTGATAATAA
CTATTATGATTACATCAAT :  TATTATGATTACATCAATA
GCTGCATCATAGTGAGGGG :  CTGCATCATAGTGAGGGGG
TCAAGAGAGCGCAGCGCGC :  CAAGAGAGCGCAGCGCGCA
TTGAGCGCGGAGATTTGTC :  TGAGCGCGGAGATTTGTCC
AAGGGTCTGAAGACACTAT :  AGGGTCTGAAGACACTATT
TTTTATGAGGCCTGGATTC :  TTTATGAGGCCTGGATTCA
TGGTACATCCTTGGAGATT :  GGTACATCCTTGGAGATTT
ACGTGAATAGAACTCCTTG :  CGTGAATAGAACTCCTTGA
CCTTTTGTAGTTCACCCTA :  CTTTTGTAGTTCACCCTAG
GGGACCAGAAGGCATAAAC :  GGACCAGAAGGCATAAACT
TCGAGATCAACTGCTCGAT :  CGAGATCAACTGCTCGATC
TCCCCCTCCGCCCGCAAGA :  CCCCCTCCGCCCGCAAGAT
CCATCCAGTGGAATTTGGA :  CATCCAGTGGAATTTGGAA
CGTACTACGAGTTGTAGTC :  GTACTACGAGTTGTAGTCA
TGGAACGAATCCTCCAGGT :  GGAACGAATCCTCCAGGTG
CGGATCGTTAAAGGGGCTA :  GGATCGTTAAAGGGGCTAT
CCGCTAATCGCGTTTAACG :  CGCTAATCGCGTTTAACGG
GTAGTCAAGAGAGCCCGAT :  TAGTCAAGAGAGCCCGATC
ACACGTAGAAGCTCTCAAA :  CACGTAGAAGCTCTCAAAG
GAGTGAGCGTGAACGGTGC :  AGTGAGCGTGAACGGTGCC
CGCGCCAGTGGAATTTGGA :  GCGCCAGTGGAATTTGGAA
CTCCGCCCGCAAGATGTCC :  TCCGCCCGCAAGATGTCCA
TACTACGAGTTGTAGTCAA :  ACTACGAGTTGTAGTCAAG
GACCCCTGACCACGACCAT :  ACCCCTGACCACGACCATG
TGCTGCAACTCGGCGCGGT :  GCTGCAACTCGGCGCGGTA
GGGACACATACTAGGACAA :  GGACACATACTAGGACAAA
AGAGTCAGGGGGCGCTAAG :  GAGTCAGGGGGCGCTAAGG
TAGATTCAGTCACCCGATG :  AGATTCAGTCACCCGATGA
GGCTCATATCATCCGACTC :  GCTCATATCATCCGACTCT
CACTATTAAAGTAGACCCC :  ACTATTAAAGTAGACCCCT
GTGCGTCTTTGCTGGCGTT :  TGCGTCTTTGCTGGCGTTT
AGCGCGGAGATTTGTCCCT :  GCGCGGAGATTTGTCCCTG
ACCGTGTTAGAGAACTGCA :  CCGTGTTAGAGAACTGCAT
GTGAATAGAACTCCTTGAG :  TGAATAGAACTCCTTGAGA
ACAAGCAGGCTGGGTACAA :  CAAGCAGGCTGGGTACAAT
CCCCTGACCACGACCATGG :  CCCTGACCACGACCATGGT
GATCAACTGCTCGATCCTG :  ATCAACTGCTCGATCCTGT
CGAAGCCATCCAGTGGAAT :  GAAGCCATCCAGTGGAATT
TGATTAACTCACGATAGTC :  GATTAACTCACGATAGTCG
ATGGCCTGAACTGGTACTG :  TGGCCTGAACTGGTACTGC
GAGGTGGATTCAGTGCAAT :  AGGTGGATTCAGTGCAATG
TACGGTTTATCAGGAGTGA :  ACGGTTTATCAGGAGTGAC
GCATTAGAAGGTGGCTCGT :  CATTAGAAGGTGGCTCGTC
TTGATGGGTGTGGTATGCC :  TGATGGGTGTGGTATGCCT
CATGCGTACGCGTCTGTTT :  ATGCGTACGCGTCTGTTTG
TCACCCGATGACCGGGGAC :  CACCCGATGACCGGGGACA
CCAATTCCGTTGTAGTCCA :  CAATTCCGTTGTAGTCCAA
GCGTTTACCCTTTCCGGGT :  CGTTTACCCTTTCCGGGTA
CTACCAGTTGCGCAGCCCA :  TACCAGTTGCGCAGCCCAG
ATCCGACTCTTATGGGCGT :  TCCGACTCTTATGGGCGTA
TGCATCGGCCTTGTGGCCT :  GCATCGGCCTTGTGGCCTT
TTAGTTGTTACCTGTCTCA :  TAGTTGTTACCTGTCTCAC
CAGTGTGCGTCTTTGCTGG :  AGTGTGCGTCTTTGCTGGC
GGCACCCGCTAATCGCGTT :  GCACCCGCTAATCGCGTTT
ATGATGCTTATTCCAGTGT :  TGATGCTTATTCCAGTGTG
TCCTCAGCTTAGGAGTAGG :  CCTCAGCTTAGGAGTAGGT
CGACTCTTATGGGCGTACC :  GACTCTTATGGGCGTACCA
CGTAGAAGCTCTCAAAGCC :  GTAGAAGCTCTCAAAGCCG
AGATTTGTCCCTGAACGCT :  GATTTGTCCCTGAACGCTG
AGTAATAAAAAAGACGTGA :  GTAATAAAAAAGACGTGAA
CCGTGATGTGCGAGGTGTG :  CGTGATGTGCGAGGTGTGC
GCGAGTGTGTATCGTTTGG :  CGAGTGTGTATCGTTTGGA
TTGGACACGTAGAAGCTCT :  TGGACACGTAGAAGCTCTC
TTGCGCAGCCCAGTGGAAT :  TGCGCAGCCCAGTGGAATT
GCGTCTGTTTGTTGAGGTG :  CGTCTGTTTGTTGAGGTGC
AGACTTACGTGGAATATAC :  GACTTACGTGGAATATACT
CGGTCTCCATGCCCAAAAT :  GGTCTCCATGCCCAAAATC
TAGGACAAAATAGTAGGCC :  AGGACAAAATAGTAGGCCA
CAAACGATACCAGTGGAAT :  AAACGATACCAGTGGAATT
TTGGATTTGATGGGTGTGG :  TGGATTTGATGGGTGTGGT
TCCGGGCTCAAGAGAGCGC :  CCGGGCTCAAGAGAGCGCA
AAGTTCTGTACCTACCAGT :  AGTTCTGTACCTACCAGTT
GTAACAAAGCCTTTTGTAG :  TAACAAAGCCTTTTGTAGT
GACACATACTAGGACAAAA :  ACACATACTAGGACAAAAT
TTTGAGGTGGATTCAGTGC :  TTGAGGTGGATTCAGTGCA
AGAGAGCCCGATCCAAGAC :  GAGAGCCCGATCCAAGACA
CTCAGAGCATTAGAAGGTG :  TCAGAGCATTAGAAGGTGG
ACACGGTGCGTGATACACG :  CACGGTGCGTGATACACGC
AACGAGAAAGAGTGCCCAG :  ACGAGAAAGAGTGCCCAGT
AGGTCCCTTCGCATCGACT :  GGTCCCTTCGCATCGACTG
TCAGGTGTTAGATTCAGTC :  CAGGTGTTAGATTCAGTCA
TCAGGGGGCGCTAAGGATC :  CAGGGGGCGCTAAGGATCC
GTTTATCAGGAGTGACCTA :  TTTATCAGGAGTGACCTAA
GATCGGTAGAATAACTCCC :  ATCGGTAGAATAACTCCCA
AGTGGAATTTGGAACGATC :  GTGGAATTTGGAACGATCA
GGTCTGAAGACACTATTAA :  GTCTGAAGACACTATTAAA
CCGGGTAGCTGACCCTACT :  CGGGTAGCTGACCCTACTG
ACAAAGCCTTTTGTAGTTC :  CAAAGCCTTTTGTAGTTCA
TTAACCCCCGACGTTGGCG :  TAACCCCCGACGTTGGCGA
CCTTGGAGATTTGAGGTGG :  CTTGGAGATTTGAGGTGGA
CCAAAAGCTGTGTGGTATT :  CAAAAGCTGTGTGGTATTG
TCCGACTCTTATGGGCGTA :  CCGACTCTTATGGGCGTAC
CAGGGCAGGGCAATGGTGC :  AGGGCAGGGCAATGGTGCA
AGCACGGGTAGCGGGGGAC :  GCACGGGTAGCGGGGGACC
TGTCTAGGCGCTGGCTATC :  GTCTAGGCGCTGGCTATCA
CAGCTTAGGAGTAGGTATC :  AGCTTAGGAGTAGGTATCC
AATAATCAGGTGTTAGATT :  ATAATCAGGTGTTAGATTC
CGGCCTGCCGAGTTCCAGC :  GGCCTGCCGAGTTCCAGCT
TCTGTACCTACCTACGAAG :  CTGTACCTACCTACGAAGC
CATATCCGGTGCATGACAA :  ATATCCGGTGCATGACAAT
GCGCGACTCACGTTAATAG :  CGCGACTCACGTTAATAGC
CTGCATGACTGCGTTTACC :  TGCATGACTGCGTTTACCC
AGTTTCATGTCTAGGCGCT :  GTTTCATGTCTAGGCGCTG
CGTTGACCGTGTTAGAGAA :  GTTGACCGTGTTAGAGAAC
AATGATTGTGCGGTGTATG :  ATGATTGTGCGGTGTATGA
GAGCGCAGCGCGCAGGTCC :  AGCGCAGCGCGCAGGTCCC
CGAGAATCTATGGTTTCTT :  GAGAATCTATGGTTTCTTC
TTCCGGGTAGCTGACCCTA :  TCCGGGTAGCTGACCCTAC
AGGGGGCTCATATCATCCG :  GGGGGCTCATATCATCCGA
CATATCATCCGACTCTTAT :  ATATCATCCGACTCTTATG
ACATACTAGGACAAAATAG :  CATACTAGGACAAAATAGT
TCAGCTTGAGTGTATTTTT :  CAGCTTGAGTGTATTTTTT
TGCCGAATGCATTTTATGA :  GCCGAATGCATTTTATGAG
CGGGTAGCTGACCCTACTG :  GGGTAGCTGACCCTACTGC
CTCCCCGGGCGGCGGGCAA :  TCCCCGGGCGGCGGGCAAC
ACTACCCACCCGATATACA :  CTACCCACCCGATATACAG
GCCGCCGATGAAGGCTTGC :  CCGCCGATGAAGGCTTGCC
TATCCAACCAACAGGGCAG :  ATCCAACCAACAGGGCAGG
AAACGATACCAGTGGAATT :  AACGATACCAGTGGAATTT
GTCTCACAAGTTCTGTACC :  TCTCACAAGTTCTGTACCT
CCTGAACGCTGCATCATAG :  CTGAACGCTGCATCATAGT
CCTGTCTCACAAGTTCTGT :  CTGTCTCACAAGTTCTGTA
ACACCCGTAGATACTACAA :  CACCCGTAGATACTACAAG
GACACTGTCTGGTAACAAA :  ACACTGTCTGGTAACAAAG
TCACGTGTTCGAGATCAAC :  CACGTGTTCGAGATCAACT
TTTACCCTTTCCGGGTAGC :  TTACCCTTTCCGGGTAGCT
CACGCAGGCACCTTGACGA :  ACGCAGGCACCTTGACGAG
GGTAACAAAGCCTTTTGTA :  GTAACAAAGCCTTTTGTAG
TCGCATCGACTGATTAGCT :  CGCATCGACTGATTAGCTG
CTTGGATTTGATGGGTGTG :  TTGGATTTGATGGGTGTGG
GAACGAGAATCTATGGTTT :  AACGAGAATCTATGGTTTC
TCACAAGTTCTGTACCTAC :  CACAAGTTCTGTACCTACC
ATCAGTATTCGCCGGAAAT :  TCAGTATTCGCCGGAAATG
CTCCTCAGCTTAGGAGTAG :  TCCTCAGCTTAGGAGTAGG
GACAAAATAGTAGGCCAGG :  ACAAAATAGTAGGCCAGGC
CTAGGCGCTGGCTATCAGT :  TAGGCGCTGGCTATCAGTA
ACTCAGCTTGAGTGTATTT :  CTCAGCTTGAGTGTATTTT
TACAAAGGCAAGTTTCATG :  ACAAAGGCAAGTTTCATGT
CGATCATTGCATCGGCCTT :  GATCATTGCATCGGCCTTG
AATATACTACTAGCATGCT :  ATATACTACTAGCATGCTG
CGATGAGGTGGTACATCCT :  GATGAGGTGGTACATCCTT
CTAATCGCGTTTAACGGCT :  TAATCGCGTTTAACGGCTT
TGGAATTTGGAACGATCAT :  GGAATTTGGAACGATCATT
TCCTTGGAGATTTGAGGTG :  CCTTGGAGATTTGAGGTGG
ACGATGGACCATTTTCACA :  CGATGGACCATTTTCACAC
TATGGTTCAGACACCTCAG :  ATGGTTCAGACACCTCAGT
TTACCCTTTCCGGGTAGCT :  TACCCTTTCCGGGTAGCTG
CAACCAAAAGCTGTGTGGT :  AACCAAAAGCTGTGTGGTA
CGATCCTGTTAAAAAGCCC :  GATCCTGTTAAAAAGCCCG
GGGGACACATACTAGGACA :  GGGACACATACTAGGACAA
TGTGCAGCGAGTGTGTATC :  GTGCAGCGAGTGTGTATCG
TTTAACGGCTTTGCACTAC :  TTAACGGCTTTGCACTACC
GATCGCTGTTCGGCCTGCC :  ATCGCTGTTCGGCCTGCCG
TCCACATGCGTACGCGTCT :  CCACATGCGTACGCGTCTG
ACCTACCTACGAAGCCATC :  CCTACCTACGAAGCCATCC
TTGTTACCTGTCTCACAAG :  TGTTACCTGTCTCACAAGT
GCAGGCTGGGTACAATTTC :  CAGGCTGGGTACAATTTCG
CCCGATGACCGGGGACACA :  CCGATGACCGGGGACACAT
TCAGACACCTCAGTCACAC :  CAGACACCTCAGTCACACC
GCGTTACGGTTTATCAGGA :  CGTTACGGTTTATCAGGAG
GGATCGCTGTTCGGCCTGC :  GATCGCTGTTCGGCCTGCC
TACTGCGGGCTCTAACAAG :  ACTGCGGGCTCTAACAAGT
GGACACATACTAGGACAAA :  GACACATACTAGGACAAAA
TCTGAAGACACTATTAAAG :  CTGAAGACACTATTAAAGT
GTGGCATTAGTTGTTACCT :  TGGCATTAGTTGTTACCTG
GTATTCGCCGGAAATGGCT :  TATTCGCCGGAAATGGCTC
TCGGCCTTGTGGCCTTATC :  CGGCCTTGTGGCCTTATCT
ACAGGGCAGGGCAATGGTG :  CAGGGCAGGGCAATGGTGC
TCACCCTAGGGGAGTGAGC :  CACCCTAGGGGAGTGAGCG
ATGCGGACAAGTTCTGTAC :  TGCGGACAAGTTCTGTACC
CGGCAAGTACAAAGGCAAG :  GGCAAGTACAAAGGCAAGT
TAGGAGTAGGTATCCAACC :  AGGAGTAGGTATCCAACCA
CTCCCCCTCCGCCCGCAAG :  TCCCCCTCCGCCCGCAAGA
GTATGGTTCAGACACCTCA :  TATGGTTCAGACACCTCAG
CCTGACCACGACCATGGTT :  CTGACCACGACCATGGTTT
ACTCACGATAGTCGAAGTT :  CTCACGATAGTCGAAGTTA
AGGCGCTGGCTATCAGTAT :  GGCGCTGGCTATCAGTATT
TCAATATTCAGCGAAATTC :  CAATATTCAGCGAAATTCA
CGTGAACGGTGCCGAATGC :  GTGAACGGTGCCGAATGCA
ACGTAGAAGCTCTCAAAGC :  CGTAGAAGCTCTCAAAGCC
ACGAAGCCATCCAGTGGAA :  CGAAGCCATCCAGTGGAAT
TACAAGTTCTGTACCTACC :  ACAAGTTCTGTACCTACCT
ATCGTTAAAGGGGCTATTA :  TCGTTAAAGGGGCTATTAT
CGCCGATGAAGGCTTGCCT :  GCCGATGAAGGCTTGCCTC
ACCACGACCATGGTTTGCA :  CCACGACCATGGTTTGCAG
TGTAGTCCAATACGTATGG :  GTAGTCCAATACGTATGGT
CGTAGACTTACGTGGAATA :  GTAGACTTACGTGGAATAT
CCCGCAAGATGTCCACGCC :  CCGCAAGATGTCCACGCCG
CACGGTGCGTGATACACGC :  ACGGTGCGTGATACACGCA
AGTGGGGCAAACGTCATAT :  GTGGGGCAAACGTCATATC
GCCGAATGCATTTTATGAG :  CCGAATGCATTTTATGAGG
GGGTACAATTTCGTTCTCA :  GGTACAATTTCGTTCTCAC
ACGGCTTTGCACTACCCAC :  CGGCTTTGCACTACCCACC
AGGTTGGCCAAATAATCAG :  GGTTGGCCAAATAATCAGG
AGACCCCTGACCACGACCA :  GACCCCTGACCACGACCAT
CCTGGTCTTGCAGTTGTCA :  CTGGTCTTGCAGTTGTCAA
GCCTTTCCTCCGGGCTCAA :  CCTTTCCTCCGGGCTCAAG
GACCGTGGTATCGCCTGGT :  ACCGTGGTATCGCCTGGTC
GGCCTTATCTAGACCGTTG :  GCCTTATCTAGACCGTTGA
CGCGACTCACGTTAATAGC :  GCGACTCACGTTAATAGCG
CCTTGAGATGGGATCGGTA :  CTTGAGATGGGATCGGTAG
TGTTCGAGATCAACTGCTC :  GTTCGAGATCAACTGCTCG
CCCTCGCGCGACTCACGTT :  CCTCGCGCGACTCACGTTA
AAGTACAAAGGCAAGTTTC :  AGTACAAAGGCAAGTTTCA
TGTGCGAGGTGTGCAGCGA :  GTGCGAGGTGTGCAGCGAG
ATCGTCTTGAGTTGAAGTG :  TCGTCTTGAGTTGAAGTGG
ACACGATGGACCATTTTCA :  CACGATGGACCATTTTCAC
CACATACTAGGACAAAATA :  ACATACTAGGACAAAATAG
ATACTACTAGCATGCTGCA :  TACTACTAGCATGCTGCAA
CAATGGCCTGAACTGGTAC :  AATGGCCTGAACTGGTACT
CAAGTTCTGTACCTACCGA :  AAGTTCTGTACCTACCGAC
AAAAGCTGTGTGGTATTGC :  AAAGCTGTGTGGTATTGCT
GGTCTCCATGCCCAAAATC :  GTCTCCATGCCCAAAATCG
GGACACGTAGAAGCTCTCA :  GACACGTAGAAGCTCTCAA
ATGGGATCGGTAGAATAAC :  TGGGATCGGTAGAATAACT
AGCTATCCCTCGCGCGACT :  GCTATCCCTCGCGCGACTC
TGCGGGCTCTAACAAGTTC :  GCGGGCTCTAACAAGTTCT
GGGAGTGAGCGTGAACGGT :  GGAGTGAGCGTGAACGGTG
GTAGATACTACAAGTTCTG :  TAGATACTACAAGTTCTGT
GTTTGGACACGTAGAAGCT :  TTTGGACACGTAGAAGCTC
ACTGCTGGCCGTGGCATTA :  CTGCTGGCCGTGGCATTAG
GCATAAACTCCCCGGGCGG :  CATAAACTCCCCGGGCGGC
ACTATTAAAGTAGACCCCT :  CTATTAAAGTAGACCCCTG
TGACTGCGTTTACCCTTTC :  GACTGCGTTTACCCTTTCC
GGCTATCAGTATTCGCCGG :  GCTATCAGTATTCGCCGGA
GCATTAGTTGTTACCTGTC :  CATTAGTTGTTACCTGTCT
TCATATCCGGTGCATGACA :  CATATCCGGTGCATGACAA
TGAGTTGAAGTGGACACGA :  GAGTTGAAGTGGACACGAT
ACTACAAGTTCTGTACCTA :  CTACAAGTTCTGTACCTAC
GCCGCACCCGCGCCTCCCC :  CCGCACCCGCGCCTCCCCC
CCCTGACCACGACCATGGT :  CCTGACCACGACCATGGTT
CGCAGCGCGCAGGTCCCTT :  GCAGCGCGCAGGTCCCTTC
TGCGTTTACCCTTTCCGGG :  GCGTTTACCCTTTCCGGGT
ATACACGCAGGCACCTTGA :  TACACGCAGGCACCTTGAC
GGACAAAATAGTAGGCCAG :  GACAAAATAGTAGGCCAGG
CCACGTGTTATCAATGCCA :  CACGTGTTATCAATGCCAC
ACGCGCCAGTGGAATTTGG :  CGCGCCAGTGGAATTTGGA
CACCCGCGCCTCCCCCTCC :  ACCCGCGCCTCCCCCTCCG
GCACGGGTAGCGGGGGACC :  CACGGGTAGCGGGGGACCA
ATCCGGTGCATGACAATGC :  TCCGGTGCATGACAATGCA
CAACTCGGCGCGGTATCAC :  AACTCGGCGCGGTATCACT
CCTTTCCTCCGGGCTCAAG :  CTTTCCTCCGGGCTCAAGA
GTATCGCCTGGTCTTGCAG :  TATCGCCTGGTCTTGCAGT
ACGATAGTCGAAGTTATAG :  CGATAGTCGAAGTTATAGA
TTTATACGCCGATGAGGTG :  TTATACGCCGATGAGGTGG
GGCGGCGGGCAACCTGAGC :  GCGGCGGGCAACCTGAGCT
TAAGCACGGGTAGCGGGGG :  AAGCACGGGTAGCGGGGGA
ACTGGTACTGCTGGCCGTG :  CTGGTACTGCTGGCCGTGG
ACAAGTTCTGTACCTACCC :  CAAGTTCTGTACCTACCCG
GAGGCCTGGATTCACACGG :  AGGCCTGGATTCACACGGT
CCTGTTAAAAAGCCCGTGA :  CTGTTAAAAAGCCCGTGAT
ATAGTCGAAGTTATAGAGT :  TAGTCGAAGTTATAGAGTC
GGTTCAGACACCTCAGTCA :  GTTCAGACACCTCAGTCAC
GTCATATCCGGTGCATGAC :  TCATATCCGGTGCATGACA
AGCCTCAGAGCATTAGAAG :  GCCTCAGAGCATTAGAAGG
GAAGGCATAAACTCCCCGG :  AAGGCATAAACTCCCCGGG
ACCACTTGTGGGACCTTTA :  CCACTTGTGGGACCTTTAA
CGAAGTAATAAAAAAGACG :  GAAGTAATAAAAAAGACGT
GTTCTGTACCTACCGACAA :  TTCTGTACCTACCGACAAA
CGTATGGTTCAGACACCTC :  GTATGGTTCAGACACCTCA
GGGTAGCTGACCCTACTGC :  GGTAGCTGACCCTACTGCG
AGCGTTACGGTTTATCAGG :  GCGTTACGGTTTATCAGGA
GGGTGTGGTATGCCTCGGC :  GGTGTGGTATGCCTCGGCC
TCCAAGACAATGGCCTGAA :  CCAAGACAATGGCCTGAAC
CACCCGCTAATCGCGTTTA :  ACCCGCTAATCGCGTTTAA
ACTGCGGGCTCTAACAAGT :  CTGCGGGCTCTAACAAGTT
CGGCTTTGCACTACCCACC :  GGCTTTGCACTACCCACCC
AGCGAAATTCAGGGGCACC :  GCGAAATTCAGGGGCACCC
CCCACGTGTTATCAATGCC :  CCACGTGTTATCAATGCCA
TCAGCTTAGGAGTAGGTAT :  CAGCTTAGGAGTAGGTATC
TGGTTTCTTCGCGGCAAGT :  GGTTTCTTCGCGGCAAGTA
TGGATTTGATGGGTGTGGT :  GGATTTGATGGGTGTGGTA
ATCATTGCATCGGCCTTGT :  TCATTGCATCGGCCTTGTG
TTAAAGTAGACCCCTGACC :  TAAAGTAGACCCCTGACCA
ACTACTAGCATGCTGCAAC :  CTACTAGCATGCTGCAACT
ACCACTCGGTACGAAAGAC :  CCACTCGGTACGAAAGACA
AGCTGACCCTACTGCGGGC :  GCTGACCCTACTGCGGGCT
CTCACGTGTTCGAGATCAA :  TCACGTGTTCGAGATCAAC
TTGGAACGAATCCTCCAGG :  TGGAACGAATCCTCCAGGT
GAATGCATTTTATGAGGCC :  AATGCATTTTATGAGGCCT
CTGTACCTACCCGGTATAC :  TGTACCTACCCGGTATACG
CATCCGACTCTTATGGGCG :  ATCCGACTCTTATGGGCGT
TGGCGTTTAGTGGCGGATT :  GGCGTTTAGTGGCGGATTG
AGACACTATTAAAGTAGAC :  GACACTATTAAAGTAGACC
GGGGAGTGAGCGTGAACGG :  GGGAGTGAGCGTGAACGGT
GATGTGCGAGGTGTGCAGC :  ATGTGCGAGGTGTGCAGCG
CGAATGCATTTTATGAGGC :  GAATGCATTTTATGAGGCC
AACTCCCCGGGCGGCGGGC :  ACTCCCCGGGCGGCGGGCA
ATCTAGACCGTTGAACCGG :  TCTAGACCGTTGAACCGGA
ATATCATCCGACTCTTATG :  TATCATCCGACTCTTATGG
GTCTTTGCTGGCGTTTAGT :  TCTTTGCTGGCGTTTAGTG
TCTAACAAGTTCTGTACCT :  CTAACAAGTTCTGTACCTA
AGTCAAGAGAGCCCGATCC :  GTCAAGAGAGCCCGATCCA
TATTCGCCGGAAATGGCTC :  ATTCGCCGGAAATGGCTCG
AATCCTCCAGGTGGCAGCT :  ATCCTCCAGGTGGCAGCTC
AAACGTCATATCCGGTGCA :  AACGTCATATCCGGTGCAT
GGTGCTTAAGAGCGCCCGT :  GTGCTTAAGAGCGCCCGTA
ACGTTGGCGAAGGGTCTGA :  CGTTGGCGAAGGGTCTGAA
AACTGCTCGATCCTGTTAA :  ACTGCTCGATCCTGTTAAA
CAATGCCACCACTCGGTAC :  AATGCCACCACTCGGTACG
GGAGTAGGTATCCAACCAA :  GAGTAGGTATCCAACCAAC
AACTGGTACTGCTGGCCGT :  ACTGGTACTGCTGGCCGTG
CTCCATGCCCAAAATCGTC :  TCCATGCCCAAAATCGTCT
TAGACTTACGTGGAATATA :  AGACTTACGTGGAATATAC
AAGCTCTCAAAGCCGCACC :  AGCTCTCAAAGCCGCACCC
TGCTGGCCGTGGCATTAGT :  GCTGGCCGTGGCATTAGTT
ATTAGTTGTTACCTGTCTC :  TTAGTTGTTACCTGTCTCA
GGAATTTGGAACGAGAATC :  GAATTTGGAACGAGAATCT
TGTCTGGTAACAAAGCCTT :  GTCTGGTAACAAAGCCTTT
CAAAGCCTTTTGTAGTTCA :  AAAGCCTTTTGTAGTTCAC
TGAGATGGGATCGGTAGAA :  GAGATGGGATCGGTAGAAT
CGCAGGCACCTTGACGAGA :  GCAGGCACCTTGACGAGAC
CTGGTAACAAAGCCTTTTG :  TGGTAACAAAGCCTTTTGT
GTTCGAGATCAACTGCTCG :  TTCGAGATCAACTGCTCGA
GTGGTATGCCTCGGCCAAC :  TGGTATGCCTCGGCCAACC
ACACCTCAGTCACACCGTG :  CACCTCAGTCACACCGTGC
GAAGGGTCTGAAGACACTA :  AAGGGTCTGAAGACACTAT
CCTACCAGTTGCGCAGCCC :  CTACCAGTTGCGCAGCCCA
TCCCTGAACGCTGCATCAT :  CCCTGAACGCTGCATCATA
AAGGCATAAACTCCCCGGG :  AGGCATAAACTCCCCGGGC
GGCTCAAGAGAGCGCAGCG :  GCTCAAGAGAGCGCAGCGC
TAACGGCTTTGCACTACCC :  AACGGCTTTGCACTACCCA
GGGTAGCGGGGGACCAGAA :  GGTAGCGGGGGACCAGAAG
TTTGGAACGAGAATCTATG :  TTGGAACGAGAATCTATGG
GAAGCCATCCAGTGGAATT :  AAGCCATCCAGTGGAATTT
AATGCATAATGGTCATACT :  ATGCATAATGGTCATACTC
AAAAAGCCCGTGATGTGCG :  AAAAGCCCGTGATGTGCGA
TAATGGTCATACTCAGCTT :  AATGGTCATACTCAGCTTG
GATGTCCACGCCGTTGACC :  ATGTCCACGCCGTTGACCG
ACAAGTTCTGTACCTACCT :  CAAGTTCTGTACCTACCTA
CTCGGTACGAAAGACACTG :  TCGGTACGAAAGACACTGT
CGGGTAGCGGGGGACCAGA :  GGGTAGCGGGGGACCAGAA
AACAAGTTCTGTACCTACC :  ACAAGTTCTGTACCTACCA
TTTATCAGGAGTGACCTAA :  TTATCAGGAGTGACCTAAT
AGTGTATTTTTTTCAAGGT :  GTGTATTTTTTTCAAGGTT
CCTACCGACAAACGATACC :  CTACCGACAAACGATACCA
CCATGCCCAAAATCGTCTT :  CATGCCCAAAATCGTCTTG
TTGCAGTATGATGCTTATT :  TGCAGTATGATGCTTATTC
GGTACATCCTTGGAGATTT :  GTACATCCTTGGAGATTTG
CTTTTGTAGTTCACCCTAG :  TTTTGTAGTTCACCCTAGG
GCGTAGACTTACGTGGAAT :  CGTAGACTTACGTGGAATA
GTATACGCGCCAGTGGAAT :  TATACGCGCCAGTGGAATT
ATCGCCTGGTCTTGCAGTT :  TCGCCTGGTCTTGCAGTTG
CCAATACGTATGGTTCAGA :  CAATACGTATGGTTCAGAC
TAGGTATCCAACCAACAGG :  AGGTATCCAACCAACAGGG
GATCGTTAAAGGGGCTATT :  ATCGTTAAAGGGGCTATTA
TCAGTATTCGCCGGAAATG :  CAGTATTCGCCGGAAATGG
AATCGTCTTGAGTTGAAGT :  ATCGTCTTGAGTTGAAGTG
ATCGCTGTTCGGCCTGCCG :  TCGCTGTTCGGCCTGCCGA
ATGCTGCAACTCGGCGCGG :  TGCTGCAACTCGGCGCGGT
CAGTGGAATTTGGAACGAA :  AGTGGAATTTGGAACGAAT
CCTGCCGAGTTCCAGCTTG :  CTGCCGAGTTCCAGCTTGG
CAGGGGCACCCGCTAATCG :  AGGGGCACCCGCTAATCGC
ACGACCATGGTTTGCAGTA :  CGACCATGGTTTGCAGTAT
GAGGTTGTCCGTGAGCCGC :  AGGTTGTCCGTGAGCCGCC
CCACTCGGTACGAAAGACA :  CACTCGGTACGAAAGACAC
GGCATTAGTTGTTACCTGT :  GCATTAGTTGTTACCTGTC
AATAACTCCCACGTGTTAT :  ATAACTCCCACGTGTTATC
TACCACTTGTGGGACCTTT :  ACCACTTGTGGGACCTTTA
ACCTAATGCGGACAAGTTC :  CCTAATGCGGACAAGTTCT
GTCGGCGAAGTAATAAAAA :  TCGGCGAAGTAATAAAAAA
GCCTCGGCCAACCAAAAGC :  CCTCGGCCAACCAAAAGCT
ATTTCGTTCTCACGTGTTC :  TTTCGTTCTCACGTGTTCG
TGCCCAAAATCGTCTTGAG :  GCCCAAAATCGTCTTGAGT
CACGCCGTTGACCGTGTTA :  ACGCCGTTGACCGTGTTAG
TTGGCCAAATAATCAGGTG :  TGGCCAAATAATCAGGTGT
CTATCCCTCGCGCGACTCA :  TATCCCTCGCGCGACTCAC
GGTGGTACATCCTTGGAGA :  GTGGTACATCCTTGGAGAT
GGCGAAGGGTCTGAAGACA :  GCGAAGGGTCTGAAGACAC
AAGACAATGGCCTGAACTG :  AGACAATGGCCTGAACTGG
GCCCAGTGACAAGCCTCAG :  CCCAGTGACAAGCCTCAGA
ATTTGGAACGAGAAAGAGT :  TTTGGAACGAGAAAGAGTG
TTGGAACGAGAAAGAGTGC :  TGGAACGAGAAAGAGTGCC
GAGTCAGGGGGCGCTAAGG :  AGTCAGGGGGCGCTAAGGA
GAACGATCATTGCATCGGC :  AACGATCATTGCATCGGCC
CCAAATAATCAGGTGTTAG :  CAAATAATCAGGTGTTAGA
GTGGCAGCTCGGTCTCCAT :  TGGCAGCTCGGTCTCCATG
AATGCGGACAAGTTCTGTA :  ATGCGGACAAGTTCTGTAC
CCGTAGATACTACAAGTTC :  CGTAGATACTACAAGTTCT
TCGCTGTTCGGCCTGCCGA :  CGCTGTTCGGCCTGCCGAG
GTACGAAAGACACTGTCTG :  TACGAAAGACACTGTCTGG
GACCGTGTTAGAGAACTGC :  ACCGTGTTAGAGAACTGCA
GAATTTGGAACGATCATTG :  AATTTGGAACGATCATTGC
CTTGCCTCGGTGTCTCGCG :  TTGCCTCGGTGTCTCGCGT
CATCGCCCAATCGCGTAGA :  ATCGCCCAATCGCGTAGAC
CTCCCACGTGTTATCAATG :  TCCCACGTGTTATCAATGC
TCAAAGCCGCACCCGCGCC :  CAAAGCCGCACCCGCGCCT
TGGGTGTGGTATGCCTCGG :  GGGTGTGGTATGCCTCGGC
AGATTTGAGGTGGATTCAG :  GATTTGAGGTGGATTCAGT
GATCCGCAATCATCGCCCA :  ATCCGCAATCATCGCCCAA
CTGCATCATAGTGAGGGGG :  TGCATCATAGTGAGGGGGC
TGGCTCGTCGGCGAAGTAA :  GGCTCGTCGGCGAAGTAAT
CGTACAAGCAGGCTGGGTA :  GTACAAGCAGGCTGGGTAC
AGACGTGAATAGAACTCCT :  GACGTGAATAGAACTCCTT
GAAGTGGACACGATGGACC :  AAGTGGACACGATGGACCA
GCCGGAAATGGCTCGGCCT :  CCGGAAATGGCTCGGCCTT
TTAGAAGGTGGCTCGTCGG :  TAGAAGGTGGCTCGTCGGC
CAAAATCGTCTTGAGTTGA :  AAAATCGTCTTGAGTTGAA
AGGTGTTAGATTCAGTCAC :  GGTGTTAGATTCAGTCACC
TACGTGGAATATACTACTA :  ACGTGGAATATACTACTAG
GCTATTATGATTACATCAA :  CTATTATGATTACATCAAT
CAGTATGATGCTTATTCCA :  AGTATGATGCTTATTCCAG
TGAACCGGATCGTTAAAGG :  GAACCGGATCGTTAAAGGG
GCGGGCAACCTGAGCTATC :  CGGGCAACCTGAGCTATCC
GAACGGTGCCGAATGCATT :  AACGGTGCCGAATGCATTT
AGGGCAATGGTGCACACCC :  GGGCAATGGTGCACACCCG
TACTAGGACAAAATAGTAG :  ACTAGGACAAAATAGTAGG
AAGCCGCACCCGCGCCTCC :  AGCCGCACCCGCGCCTCCC
ATGACCGGGGACACATACT :  TGACCGGGGACACATACTA
CAGCTCGGTCTCCATGCCC :  AGCTCGGTCTCCATGCCCA
ACCTCAGTCACACCGTGCC :  CCTCAGTCACACCGTGCCA
GCCCAGTGGAATTTGGAAC :  CCCAGTGGAATTTGGAACG
CGACCATGGTTTGCAGTAT :  GACCATGGTTTGCAGTATG
CAATAAGTGGGGCAAACGT :  AATAAGTGGGGCAAACGTC
CGGGCTCTAACAAGTTCTG :  GGGCTCTAACAAGTTCTGT
CACCTTGACGAGACCGTGG :  ACCTTGACGAGACCGTGGT
GGAGTGAGCGTGAACGGTG :  GAGTGAGCGTGAACGGTGC
GACACTATTAAAGTAGACC :  ACACTATTAAAGTAGACCC
CCGGTGCATGACAATGCAT :  CGGTGCATGACAATGCATA
GCGTGAACGGTGCCGAATG :  CGTGAACGGTGCCGAATGC
ATAATAAGCACGGGTAGCG :  TAATAAGCACGGGTAGCGG
CAATACGTATGGTTCAGAC :  AATACGTATGGTTCAGACA
GGGGGCGCTAAGGATCCGC :  GGGGCGCTAAGGATCCGCA
GTTGTCCGTGAGCCGCCGA :  TTGTCCGTGAGCCGCCGAT
GTCCCTGAACGCTGCATCA :  TCCCTGAACGCTGCATCAT
AGGGCAGGGCAATGGTGCA :  GGGCAGGGCAATGGTGCAC
CGCTAATCGCGTTTAACGG :  GCTAATCGCGTTTAACGGC
CAAGGTTGGCCAAATAATC :  AAGGTTGGCCAAATAATCA
CCTACTGCGGGCTCTAACA :  CTACTGCGGGCTCTAACAA
ACTAGGACAAAATAGTAGG :  CTAGGACAAAATAGTAGGC
ACTTACGTGGAATATACTA :  CTTACGTGGAATATACTAC
ACCTGTCTCACAAGTTCTG :  CCTGTCTCACAAGTTCTGT
CCTACCTACGAAGCCATCC :  CTACCTACGAAGCCATCCA
TCAAGGTTGGCCAAATAAT :  CAAGGTTGGCCAAATAATC
TACATCCTTGGAGATTTGA :  ACATCCTTGGAGATTTGAG
ATGGTTTCTTCGCGGCAAG :  TGGTTTCTTCGCGGCAAGT
GAACCGGATCGTTAAAGGG :  AACCGGATCGTTAAAGGGG
AGATTCAGTCACCCGATGA :  GATTCAGTCACCCGATGAC
GTGCAATGGTGATAATAAG :  TGCAATGGTGATAATAAGC
AATGGCCTGAACTGGTACT :  ATGGCCTGAACTGGTACTG
GGCCTTTCCTCCGGGCTCA :  GCCTTTCCTCCGGGCTCAA
GAATCCTCCAGGTGGCAGC :  AATCCTCCAGGTGGCAGCT
GTTTCTTCGCGGCAAGTAC :  TTTCTTCGCGGCAAGTACA
GGGCGGCGGGCAACCTGAG :  GGCGGCGGGCAACCTGAGC
ATGCCCAAAATCGTCTTGA :  TGCCCAAAATCGTCTTGAG
TACTGCTGGCCGTGGCATT :  ACTGCTGGCCGTGGCATTA
TCGGTACGAAAGACACTGT :  CGGTACGAAAGACACTGTC
CCTTATCTAGACCGTTGAA :  CTTATCTAGACCGTTGAAC
GCGGAGATTTGTCCCTGAA :  CGGAGATTTGTCCCTGAAC
CGACAAACGATACCAGTGG :  GACAAACGATACCAGTGGA
AGGTGGTACATCCTTGGAG :  GGTGGTACATCCTTGGAGA
AGTCACACCGTGCCAATGA :  GTCACACCGTGCCAATGAT
CAATTTCGTTCTCACGTGT :  AATTTCGTTCTCACGTGTT
GCGAAATTCAGGGGCACCC :  CGAAATTCAGGGGCACCCG
ACTAGCATGCTGCAACTCG :  CTAGCATGCTGCAACTCGG
ATGTCTAGGCGCTGGCTAT :  TGTCTAGGCGCTGGCTATC
ACGGTGCCGAATGCATTTT :  CGGTGCCGAATGCATTTTA
GTTGGCGAAGGGTCTGAAG :  TTGGCGAAGGGTCTGAAGA
GAAGACACTATTAAAGTAG :  AAGACACTATTAAAGTAGA
AGAAGCTCTCAAAGCCGCA :  GAAGCTCTCAAAGCCGCAC
AATAAGTGGGGCAAACGTC :  ATAAGTGGGGCAAACGTCA
CTCGATCCTGTTAAAAAGC :  TCGATCCTGTTAAAAAGCC
TGGCTATCAGTATTCGCCG :  GGCTATCAGTATTCGCCGG
ATTCACACGGTGCGTGATA :  TTCACACGGTGCGTGATAC
ACTGCATGACTGCGTTTAC :  CTGCATGACTGCGTTTACC
GCAAGATGTCCACGCCGTT :  CAAGATGTCCACGCCGTTG
GCAACCTGAGCTATCCCTC :  CAACCTGAGCTATCCCTCG
GCTCGATCCTGTTAAAAAG :  CTCGATCCTGTTAAAAAGC
CGATGAAGGCTTGCCTCGG :  GATGAAGGCTTGCCTCGGT
GCAGTTGTCAATATTCAGC :  CAGTTGTCAATATTCAGCG
GGTGTGGTATGCCTCGGCC :  GTGTGGTATGCCTCGGCCA
CAAAGGCAAGTTTCATGTC :  AAAGGCAAGTTTCATGTCT
AGATGTCCACGCCGTTGAC :  GATGTCCACGCCGTTGACC
TCGTTAAAGGGGCTATTAT :  CGTTAAAGGGGCTATTATG
AGTCGAAGTTATAGAGTCA :  GTCGAAGTTATAGAGTCAG
GGGGCACCCGCTAATCGCG :  GGGCACCCGCTAATCGCGT
TTTCTTCGCGGCAAGTACA :  TTCTTCGCGGCAAGTACAA
CCGTTGACCGTGTTAGAGA :  CGTTGACCGTGTTAGAGAA
GACCAGAAGGCATAAACTC :  ACCAGAAGGCATAAACTCC
CAAGCAGGCTGGGTACAAT :  AAGCAGGCTGGGTACAATT
CGTTTACCCTTTCCGGGTA :  GTTTACCCTTTCCGGGTAG
CGTGGCATTAGTTGTTACC :  GTGGCATTAGTTGTTACCT
TCCACGCCGTTGACCGTGT :  CCACGCCGTTGACCGTGTT
GAAGGTGGCTCGTCGGCGA :  AAGGTGGCTCGTCGGCGAA
CCAGTGGAATTTGGAACGA :  CAGTGGAATTTGGAACGAG CAGTGGAATTTGGAACGAA CAGTGGAATTTGGAACGAG CAGTGGAATTTGGAACGAT
CGGGCGGCGGGCAACCTGA :  GGGCGGCGGGCAACCTGAG
AGCCTTTTGTAGTTCACCC :  GCCTTTTGTAGTTCACCCT
GGCATAAACTCCCCGGGCG :  GCATAAACTCCCCGGGCGG
CAATTCCGTTGTAGTCCAA :  AATTCCGTTGTAGTCCAAT
GATGGGTGTGGTATGCCTC :  ATGGGTGTGGTATGCCTCG
AGGCTTGCCTCGGTGTCTC :  GGCTTGCCTCGGTGTCTCG
GGCACCTTGACGAGACCGT :  GCACCTTGACGAGACCGTG
GATTCACACGGTGCGTGAT :  ATTCACACGGTGCGTGATA
CAGCGCGCAGGTCCCTTCG :  AGCGCGCAGGTCCCTTCGC
GTGAGCGTGAACGGTGCCG :  TGAGCGTGAACGGTGCCGA
CTGCGTTTACCCTTTCCGG :  TGCGTTTACCCTTTCCGGG
CTTTAACCCCCGACGTTGG :  TTTAACCCCCGACGTTGGC
CTTATGGGCGTACCAGAGG :  TTATGGGCGTACCAGAGGT
ATAAAAAAGACGTGAATAG :  TAAAAAAGACGTGAATAGA
TCTCCATGCCCAAAATCGT :  CTCCATGCCCAAAATCGTC
ATAATCAGGTGTTAGATTC :  TAATCAGGTGTTAGATTCA
GAACGAATCCTCCAGGTGG :  AACGAATCCTCCAGGTGGC
TTAAAAAGCCCGTGATGTG :  TAAAAAGCCCGTGATGTGC
GGTTGGCCAAATAATCAGG :  GTTGGCCAAATAATCAGGT
CATCGACTGATTAGCTGTT :  ATCGACTGATTAGCTGTTT
CAGACACCTCAGTCACACC :  AGACACCTCAGTCACACCG
GCGGTGTATGATTAACTCA :  CGGTGTATGATTAACTCAC
TTGACTACCACTTGTGGGA :  TGACTACCACTTGTGGGAC
TCATACTCAGCTTGAGTGT :  CATACTCAGCTTGAGTGTA
ATTAAAGTAGACCCCTGAC :  TTAAAGTAGACCCCTGACC
CCTCCGCCCGCAAGATGTC :  CTCCGCCCGCAAGATGTCC
GGGGCGCTAAGGATCCGCA :  GGGCGCTAAGGATCCGCAA
TCTCAAAGCCGCACCCGCG :  CTCAAAGCCGCACCCGCGC
AAAGCCCGTGATGTGCGAG :  AAGCCCGTGATGTGCGAGG
CTGTACCTACCTACGAAGC :  TGTACCTACCTACGAAGCC
GATGACCGGGGACACATAC :  ATGACCGGGGACACATACT
GGCCGTGGCATTAGTTGTT :  GCCGTGGCATTAGTTGTTA
TCGTTTGGACACGTAGAAG :  CGTTTGGACACGTAGAAGC
AGTAGGCCAGGCTTAACTT :  GTAGGCCAGGCTTAACTTG
GTGTTAGAGAACTGCATGA :  TGTTAGAGAACTGCATGAC
TAGATACTACAAGTTCTGT :  AGATACTACAAGTTCTGTA
TTTAGTGGCGGATTGAGCG :  TTAGTGGCGGATTGAGCGC
CAATCGCGTAGACTTACGT :  AATCGCGTAGACTTACGTG
GTATTTTTTTCAAGGTTGG :  TATTTTTTTCAAGGTTGGC
GGGATCGGTAGAATAACTC :  GGATCGGTAGAATAACTCC
GCCAAATAATCAGGTGTTA :  CCAAATAATCAGGTGTTAG
GTGAGGGGGCTCATATCAT :  TGAGGGGGCTCATATCATC
ACCGTGGTATCGCCTGGTC :  CCGTGGTATCGCCTGGTCT
GGTAGCGGGGGACCAGAAG :  GTAGCGGGGGACCAGAAGG
GTCATACTCAGCTTGAGTG :  TCATACTCAGCTTGAGTGT
GTAATAAAAAAGACGTGAA :  TAATAAAAAAGACGTGAAT
ATCCAGTGGAATTTGGAAC :  TCCAGTGGAATTTGGAACG
TCGCGTAGACTTACGTGGA :  CGCGTAGACTTACGTGGAA
GATCATTGCATCGGCCTTG :  ATCATTGCATCGGCCTTGT
AGAGCGCCCGTACTACGAG :  GAGCGCCCGTACTACGAGT
TGTACCTACCGACAAACGA :  GTACCTACCGACAAACGAT
TAAAAAGCCCGTGATGTGC :  AAAAAGCCCGTGATGTGCG
ATCCTGTTAAAAAGCCCGT :  TCCTGTTAAAAAGCCCGTG
GGATTCAGTGCAATGGTGA :  GATTCAGTGCAATGGTGAT
GCCACCACTCGGTACGAAA :  CCACCACTCGGTACGAAAG
AACTCCTTGAGATGGGATC :  ACTCCTTGAGATGGGATCG
GGATTTGATGGGTGTGGTA :  GATTTGATGGGTGTGGTAT
TGGTATGCCTCGGCCAACC :  GGTATGCCTCGGCCAACCA
GTACAAAGGCAAGTTTCAT :  TACAAAGGCAAGTTTCATG
AGGTTGTCCGTGAGCCGCC :  GGTTGTCCGTGAGCCGCCG
TCGCGGCAAGTACAAAGGC :  CGCGGCAAGTACAAAGGCA
CATTTTATGAGGCCTGGAT :  ATTTTATGAGGCCTGGATT
AAGTAATAAAAAAGACGTG :  AGTAATAAAAAAGACGTGA
TTGACCGTGTTAGAGAACT :  TGACCGTGTTAGAGAACTG
GCCGTTGACCGTGTTAGAG :  CCGTTGACCGTGTTAGAGA
TAGGGGAGTGAGCGTGAAC :  AGGGGAGTGAGCGTGAACG
CGAAATTCAGGGGCACCCG :  GAAATTCAGGGGCACCCGC
CAAGTACAAAGGCAAGTTT :  AAGTACAAAGGCAAGTTTC
GTTCTCCTCAGCTTAGGAG :  TTCTCCTCAGCTTAGGAGT
CGGCGAAGTAATAAAAAAG :  GGCGAAGTAATAAAAAAGA
CGATAGTCGAAGTTATAGA :  GATAGTCGAAGTTATAGAG
TCGGTAGAATAACTCCCAC :  CGGTAGAATAACTCCCACG
AGAATCTATGGTTTCTTCG :  GAATCTATGGTTTCTTCGC
CACCACTCGGTACGAAAGA :  ACCACTCGGTACGAAAGAC
GCTTAAGAGCGCCCGTACT :  CTTAAGAGCGCCCGTACTA
GAATTTGGAACGAATCCTC :  AATTTGGAACGAATCCTCC
GTAGACTTACGTGGAATAT :  TAGACTTACGTGGAATATA
GGACACGATGGACCATTTT :  GACACGATGGACCATTTTC
ATCCAACCAACAGGGCAGG :  TCCAACCAACAGGGCAGGG
GCGTTTAGTGGCGGATTGA :  CGTTTAGTGGCGGATTGAG
CCTCAGCTTAGGAGTAGGT :  CTCAGCTTAGGAGTAGGTA
AGAATAACTCCCACGTGTT :  GAATAACTCCCACGTGTTA
TAATAAAAAAGACGTGAAT :  AATAAAAAAGACGTGAATA
GACCGTTGAACCGGATCGT :  ACCGTTGAACCGGATCGTT
TTTATGAGGCCTGGATTCA :  TTATGAGGCCTGGATTCAC
CGCCGATGAGGTGGTACAT :  GCCGATGAGGTGGTACATC
TGCCACCACTCGGTACGAA :  GCCACCACTCGGTACGAAA
CGTACGCGTCTGTTTGTTG :  GTACGCGTCTGTTTGTTGA
CGGCCTTTCCTCCGGGCTC :  GGCCTTTCCTCCGGGCTCA
ATAATGGTCATACTCAGCT :  TAATGGTCATACTCAGCTT
GACAAACGATACCAGTGGA :  ACAAACGATACCAGTGGAA
TAAAGTAGACCCCTGACCA :  AAAGTAGACCCCTGACCAC
AAAAAAGACGTGAATAGAA :  AAAAAGACGTGAATAGAAC
GCCGTGGCATTAGTTGTTA :  CCGTGGCATTAGTTGTTAC
TCAATGCCACCACTCGGTA :  CAATGCCACCACTCGGTAC
TTACGTGGAATATACTACT :  TACGTGGAATATACTACTA
GTTGACCGTGTTAGAGAAC :  TTGACCGTGTTAGAGAACT
CCTCAGTCACACCGTGCCA :  CTCAGTCACACCGTGCCAA
ACTCCCACGTGTTATCAAT :  CTCCCACGTGTTATCAATG
TAGCATGCTGCAACTCGGC :  AGCATGCTGCAACTCGGCG
TAACAAAGCCTTTTGTAGT :  AACAAAGCCTTTTGTAGTT
GAAGTTATAGAGTCAGGGG :  AAGTTATAGAGTCAGGGGG
GTATCGTTTGGACACGTAG :  TATCGTTTGGACACGTAGA
AAGAGCGCCCGTACTACGA :  AGAGCGCCCGTACTACGAG
GCAGCCCAGTGGAATTTGG :  CAGCCCAGTGGAATTTGGA
TTGTTGAGGTGCTTAAGAG :  TGTTGAGGTGCTTAAGAGC
CCGACTCTTATGGGCGTAC :  CGACTCTTATGGGCGTACC
TCGCCCAATCGCGTAGACT :  CGCCCAATCGCGTAGACTT
TAAACTCCCCGGGCGGCGG :  AAACTCCCCGGGCGGCGGG
TTTGGAACGAATCCTCCAG :  TTGGAACGAATCCTCCAGG
AATGCATTTTATGAGGCCT :  ATGCATTTTATGAGGCCTG
ATGCATAATGGTCATACTC :  TGCATAATGGTCATACTCA
GCAATGGTGCACACCCGTA :  CAATGGTGCACACCCGTAG
ATCGACTGATTAGCTGTTT :  TCGACTGATTAGCTGTTTA
TCGTCGGCGAAGTAATAAA :  CGTCGGCGAAGTAATAAAA
ACAAGTTCTGTACCTACCG :  CAAGTTCTGTACCTACCGA
TTTTTTTCAAGGTTGGCCA :  TTTTTTCAAGGTTGGCCAA
AGGCATAAACTCCCCGGGC :  GGCATAAACTCCCCGGGCG
CCAGGTGGCAGCTCGGTCT :  CAGGTGGCAGCTCGGTCTC
ATAGAACTCCTTGAGATGG :  TAGAACTCCTTGAGATGGG
ATGGACCATTTTCACACCA :  TGGACCATTTTCACACCAA
CCCAGTGGAATTTGGAACG :  CCAGTGGAATTTGGAACGA
TGCGTGATACACGCAGGCA :  GCGTGATACACGCAGGCAC
AGACACCTCAGTCACACCG :  GACACCTCAGTCACACCGT
CCGGGGACACATACTAGGA :  CGGGGACACATACTAGGAC
TGAACGCTGCATCATAGTG :  GAACGCTGCATCATAGTGA
AAAATCGTCTTGAGTTGAA :  AAATCGTCTTGAGTTGAAG
CCGTGGCATTAGTTGTTAC :  CGTGGCATTAGTTGTTACC
GCCTGGTCTTGCAGTTGTC :  CCTGGTCTTGCAGTTGTCA
AGTGGACACGATGGACCAT :  GTGGACACGATGGACCATT
GGCAAGTACAAAGGCAAGT :  GCAAGTACAAAGGCAAGTT
CACAAGTTCTGTACCTACC :  ACAAGTTCTGTACCTACCC
AGATCAACTGCTCGATCCT :  GATCAACTGCTCGATCCTG
AGCGAGTGTGTATCGTTTG :  GCGAGTGTGTATCGTTTGG
CCCTACTGCGGGCTCTAAC :  CCTACTGCGGGCTCTAACA
CACCGTGCCAATGATTGTG :  ACCGTGCCAATGATTGTGC
GGCGCTGGCTATCAGTATT :  GCGCTGGCTATCAGTATTC
ATCCTTGGAGATTTGAGGT :  TCCTTGGAGATTTGAGGTG
AAGTTCTGTACCTACCGAC :  AGTTCTGTACCTACCGACA
TAGAGAACTGCATGACTGC :  AGAGAACTGCATGACTGCG
ATTTTATGAGGCCTGGATT :  TTTTATGAGGCCTGGATTC
TGTAGTCAAGAGAGCCCGA :  GTAGTCAAGAGAGCCCGAT
GTGCGGTGTATGATTAACT :  TGCGGTGTATGATTAACTC
TCGAAGTTATAGAGTCAGG :  CGAAGTTATAGAGTCAGGG
GGAAATGGCTCGGCCTTTC :  GAAATGGCTCGGCCTTTCC
TTCTGTACCTACCCGGTAT :  TCTGTACCTACCCGGTATA
ACGAATCCTCCAGGTGGCA :  CGAATCCTCCAGGTGGCAG
TGAGCTATCCCTCGCGCGA :  GAGCTATCCCTCGCGCGAC
TATGAGGCCTGGATTCACA :  ATGAGGCCTGGATTCACAC
GTGGGGCAAACGTCATATC :  TGGGGCAAACGTCATATCC
ACGTATGGTTCAGACACCT :  CGTATGGTTCAGACACCTC
GAGTTGAAGTGGACACGAT :  AGTTGAAGTGGACACGATG
GGCGTACCAGAGGTTGTCC :  GCGTACCAGAGGTTGTCCG
CTCCACATGCGTACGCGTC :  TCCACATGCGTACGCGTCT
TGGTGCACACCCGTAGATA :  GGTGCACACCCGTAGATAC
CAGCGAGTGTGTATCGTTT :  AGCGAGTGTGTATCGTTTG
ATATTCAGCGAAATTCAGG :  TATTCAGCGAAATTCAGGG
TTCCAGTGTGCGTCTTTGC :  TCCAGTGTGCGTCTTTGCT
CAGTGACAAGCCTCAGAGC :  AGTGACAAGCCTCAGAGCA
ATTCAGTGCAATGGTGATA :  TTCAGTGCAATGGTGATAA
CCAGTGACAAGCCTCAGAG :  CAGTGACAAGCCTCAGAGC
AGGGTCTGAAGACACTATT :  GGGTCTGAAGACACTATTA
TCGGTGTCTCGCGTACAAG :  CGGTGTCTCGCGTACAAGC
AAATAGTAGGCCAGGCTTA :  AATAGTAGGCCAGGCTTAA
AAGAGTGCCCAGTGACAAG :  AGAGTGCCCAGTGACAAGC
CAAGTTTCATGTCTAGGCG :  AAGTTTCATGTCTAGGCGC
GCCATCCAGTGGAATTTGG :  CCATCCAGTGGAATTTGGA
GGCGGATTGAGCGCGGAGA :  GCGGATTGAGCGCGGAGAT
TATCGCCTGGTCTTGCAGT :  ATCGCCTGGTCTTGCAGTT
TGGCCAAATAATCAGGTGT :  GGCCAAATAATCAGGTGTT
CACTGTCTGGTAACAAAGC :  ACTGTCTGGTAACAAAGCC
TTTGCAGTATGATGCTTAT :  TTGCAGTATGATGCTTATT
TTGGAGATTTGAGGTGGAT :  TGGAGATTTGAGGTGGATT
GGCTGGGTACAATTTCGTT :  GCTGGGTACAATTTCGTTC
TGTCCACGCCGTTGACCGT :  GTCCACGCCGTTGACCGTG
CATTAGAAGGTGGCTCGTC :  ATTAGAAGGTGGCTCGTCG
CTGCGGGCTCTAACAAGTT :  TGCGGGCTCTAACAAGTTC
GTAGCTGACCCTACTGCGG :  TAGCTGACCCTACTGCGGG
ACGTGTTCGAGATCAACTG :  CGTGTTCGAGATCAACTGC
CCTAATGCGGACAAGTTCT :  CTAATGCGGACAAGTTCTG
TGATTAGCTGTTTATACGC :  GATTAGCTGTTTATACGCC
ATACGCGCCAGTGGAATTT :  TACGCGCCAGTGGAATTTG
GTCAAGAGAGCCCGATCCA :  TCAAGAGAGCCCGATCCAA
ACCTTTAACCCCCGACGTT :  CCTTTAACCCCCGACGTTG
TGCATGACTGCGTTTACCC :  GCATGACTGCGTTTACCCT
ATAAACTCCCCGGGCGGCG :  TAAACTCCCCGGGCGGCGG
AAGGCAAGTTTCATGTCTA :  AGGCAAGTTTCATGTCTAG
TGGAACGATCATTGCATCG :  GGAACGATCATTGCATCGG
TGCGGACAAGTTCTGTACC :  GCGGACAAGTTCTGTACCT
GAGCGTGAACGGTGCCGAA :  AGCGTGAACGGTGCCGAAT
TTAACTTGACTACCACTTG :  TAACTTGACTACCACTTGT
GAGGTGTGCAGCGAGTGTG :  AGGTGTGCAGCGAGTGTGT
CAATGGTGCACACCCGTAG :  AATGGTGCACACCCGTAGA
GAAATGGCTCGGCCTTTCC :  AAATGGCTCGGCCTTTCCT
TGGAATTTGGAACGAATCC :  GGAATTTGGAACGAATCCT
TTATGATTACATCAATAAG :  TATGATTACATCAATAAGT
CAACTGCTCGATCCTGTTA :  AACTGCTCGATCCTGTTAA
GCTTAGGAGTAGGTATCCA :  CTTAGGAGTAGGTATCCAA
TACCAGTTGCGCAGCCCAG :  ACCAGTTGCGCAGCCCAGT
TTGACGAGACCGTGGTATC :  TGACGAGACCGTGGTATCG
ACGATCATTGCATCGGCCT :  CGATCATTGCATCGGCCTT
ACAATGCATAATGGTCATA :  CAATGCATAATGGTCATAC
CACCTCAGTCACACCGTGC :  ACCTCAGTCACACCGTGCC
AAGGTTGGCCAAATAATCA :  AGGTTGGCCAAATAATCAG
TGTTGAGGTGCTTAAGAGC :  GTTGAGGTGCTTAAGAGCG
TATTAAAGTAGACCCCTGA :  ATTAAAGTAGACCCCTGAC
TCAGGGGCACCCGCTAATC :  CAGGGGCACCCGCTAATCG
CCCTGAACGCTGCATCATA :  CCTGAACGCTGCATCATAG
ATGTGCGAGGTGTGCAGCG :  TGTGCGAGGTGTGCAGCGA
GATACTACAAGTTCTGTAC :  ATACTACAAGTTCTGTACC
CCACATGCGTACGCGTCTG :  CACATGCGTACGCGTCTGT
TGCACACCCGTAGATACTA :  GCACACCCGTAGATACTAC
TACGAAGCCATCCAGTGGA :  ACGAAGCCATCCAGTGGAA
GTGATGTGCGAGGTGTGCA :  TGATGTGCGAGGTGTGCAG
TGGACACGTAGAAGCTCTC :  GGACACGTAGAAGCTCTCA
ACCATGGTTTGCAGTATGA :  CCATGGTTTGCAGTATGAT
GCCTGAACTGGTACTGCTG :  CCTGAACTGGTACTGCTGG
AGTCCAATACGTATGGTTC :  GTCCAATACGTATGGTTCA
GTCTTGAGTTGAAGTGGAC :  TCTTGAGTTGAAGTGGACA
GCCAACCAAAAGCTGTGTG :  CCAACCAAAAGCTGTGTGG
TCATAGTGAGGGGGCTCAT :  CATAGTGAGGGGGCTCATA
AATATTCAGCGAAATTCAG :  ATATTCAGCGAAATTCAGG
AACTCACGATAGTCGAAGT :  ACTCACGATAGTCGAAGTT
GTGTATGATTAACTCACGA :  TGTATGATTAACTCACGAT
TCAAGAGAGCCCGATCCAA :  CAAGAGAGCCCGATCCAAG
GGGCGTACCAGAGGTTGTC :  GGCGTACCAGAGGTTGTCC
GCATCGACTGATTAGCTGT :  CATCGACTGATTAGCTGTT
TGTCCCTGAACGCTGCATC :  GTCCCTGAACGCTGCATCA
TAGCTGACCCTACTGCGGG :  AGCTGACCCTACTGCGGGC
CGTTAATAGCGTTACGGTT :  GTTAATAGCGTTACGGTTT
ATAGTGAGGGGGCTCATAT :  TAGTGAGGGGGCTCATATC
TCGACTGATTAGCTGTTTA :  CGACTGATTAGCTGTTTAT
ATCGGCCTTGTGGCCTTAT :  TCGGCCTTGTGGCCTTATC
GCGCCCGTACTACGAGTTG :  CGCCCGTACTACGAGTTGT
GGTAGCTGACCCTACTGCG :  GTAGCTGACCCTACTGCGG
TATCGTTTGGACACGTAGA :  ATCGTTTGGACACGTAGAA
GTGTTATCAATGCCACCAC :  TGTTATCAATGCCACCACT
GAGTTCCAGCTTGGATTTG :  AGTTCCAGCTTGGATTTGA
GCAAACGTCATATCCGGTG :  CAAACGTCATATCCGGTGC
TGACGAGACCGTGGTATCG :  GACGAGACCGTGGTATCGC
TATGCCTCGGCCAACCAAA :  ATGCCTCGGCCAACCAAAA
TGCGTCTTTGCTGGCGTTT :  GCGTCTTTGCTGGCGTTTA
ATAACTCCCACGTGTTATC :  TAACTCCCACGTGTTATCA
CTGAGCTATCCCTCGCGCG :  TGAGCTATCCCTCGCGCGA
CTACGAAGCCATCCAGTGG :  TACGAAGCCATCCAGTGGA
TTGTCCGTGAGCCGCCGAT :  TGTCCGTGAGCCGCCGATG
CCAGAAGGCATAAACTCCC :  CAGAAGGCATAAACTCCCC
AGTTGTAGTCAAGAGAGCC :  GTTGTAGTCAAGAGAGCCC
GTGTATCGTTTGGACACGT :  TGTATCGTTTGGACACGTA
CCGCAATCATCGCCCAATC :  CGCAATCATCGCCCAATCG
GTGCATGACAATGCATAAT :  TGCATGACAATGCATAATG
GCCAATGATTGTGCGGTGT :  CCAATGATTGTGCGGTGTA
TAGTTCACCCTAGGGGAGT :  AGTTCACCCTAGGGGAGTG
TTTCGTTCTCACGTGTTCG :  TTCGTTCTCACGTGTTCGA
CTTTGCACTACCCACCCGA :  TTTGCACTACCCACCCGAT
AGTACAAAGGCAAGTTTCA :  GTACAAAGGCAAGTTTCAT
GAGCATTAGAAGGTGGCTC :  AGCATTAGAAGGTGGCTCG
GTGGAATATACTACTAGCA :  TGGAATATACTACTAGCAT
GTTATCAATGCCACCACTC :  TTATCAATGCCACCACTCG
CTACGAGTTGTAGTCAAGA :  TACGAGTTGTAGTCAAGAG
CGGTGCATGACAATGCATA :  GGTGCATGACAATGCATAA
TGCCTCGGCCAACCAAAAG :  GCCTCGGCCAACCAAAAGC
TGTGGTATTGCTCCACATG :  GTGGTATTGCTCCACATGC
AACTTGACTACCACTTGTG :  ACTTGACTACCACTTGTGG
GTCTGAAGACACTATTAAA :  TCTGAAGACACTATTAAAG
GCGGATTGAGCGCGGAGAT :  CGGATTGAGCGCGGAGATT
AGCGCGCAGGTCCCTTCGC :  GCGCGCAGGTCCCTTCGCA
CTGTTCGGCCTGCCGAGTT :  TGTTCGGCCTGCCGAGTTC
TCCTCCAGGTGGCAGCTCG :  CCTCCAGGTGGCAGCTCGG
CTTGAGTGTATTTTTTTCA :  TTGAGTGTATTTTTTTCAA
GGGACCTTTAACCCCCGAC :  GGACCTTTAACCCCCGACG
CCAGCTTGGATTTGATGGG :  CAGCTTGGATTTGATGGGT
GTCCAATACGTATGGTTCA :  TCCAATACGTATGGTTCAG
GATTCAGTCACCCGATGAC :  ATTCAGTCACCCGATGACC
TAATCGCGTTTAACGGCTT :  AATCGCGTTTAACGGCTTT
AATCTATGGTTTCTTCGCG :  ATCTATGGTTTCTTCGCGG
GGTCTTGCAGTTGTCAATA :  GTCTTGCAGTTGTCAATAT
ATGGTCATACTCAGCTTGA :  TGGTCATACTCAGCTTGAG
GGCGGGCAACCTGAGCTAT :  GCGGGCAACCTGAGCTATC
AGTTCTGTACCTACCAGTT :  GTTCTGTACCTACCAGTTG
ACGTTAATAGCGTTACGGT :  CGTTAATAGCGTTACGGTT
AGACACTGTCTGGTAACAA :  GACACTGTCTGGTAACAAA
TTTCATGTCTAGGCGCTGG :  TTCATGTCTAGGCGCTGGC
GGAATATACTACTAGCATG :  GAATATACTACTAGCATGC
CTCGGTGTCTCGCGTACAA :  TCGGTGTCTCGCGTACAAG
GTTCTCACGTGTTCGAGAT :  TTCTCACGTGTTCGAGATC
TAGGCGCTGGCTATCAGTA :  AGGCGCTGGCTATCAGTAT
GCACCCGCTAATCGCGTTT :  CACCCGCTAATCGCGTTTA
CAAGAGAGCCCGATCCAAG :  AAGAGAGCCCGATCCAAGA
TGTACCTACCTACGAAGCC :  GTACCTACCTACGAAGCCA
TCAGTGCAATGGTGATAAT :  CAGTGCAATGGTGATAATA
CGCCAGTGGAATTTGGAAC :  GCCAGTGGAATTTGGAACG
ACCGTGCCAATGATTGTGC :  CCGTGCCAATGATTGTGCG
GTTCACCCTAGGGGAGTGA :  TTCACCCTAGGGGAGTGAG
ACCAGTGGAATTTGGAACG :  CCAGTGGAATTTGGAACGA
AGCGGGGGACCAGAAGGCA :  GCGGGGGACCAGAAGGCAT
AAGAGAGCCCGATCCAAGA :  AGAGAGCCCGATCCAAGAC
GTGATAATAAGCACGGGTA :  TGATAATAAGCACGGGTAG
CGTTAAAGGGGCTATTATG :  GTTAAAGGGGCTATTATGA
TGCCGAGTTCCAGCTTGGA :  GCCGAGTTCCAGCTTGGAT
ACCAACAGGGCAGGGCAAT :  CCAACAGGGCAGGGCAATG
GAGCGCGGAGATTTGTCCC :  AGCGCGGAGATTTGTCCCT
CACCCGATATACAGTTTCA :  ACCCGATATACAGTTTCAA
TGTTAAAAAGCCCGTGATG :  GTTAAAAAGCCCGTGATGT
TAGTAGGCCAGGCTTAACT :  AGTAGGCCAGGCTTAACTT
TCTGGTAACAAAGCCTTTT :  CTGGTAACAAAGCCTTTTG
TCCGTGAGCCGCCGATGAA :  CCGTGAGCCGCCGATGAAG
CACGATAGTCGAAGTTATA :  ACGATAGTCGAAGTTATAG
GCGCCTCCCCCTCCGCCCG :  CGCCTCCCCCTCCGCCCGC
TCTCGCGTACAAGCAGGCT :  CTCGCGTACAAGCAGGCTG
GGTGCGTGATACACGCAGG :  GTGCGTGATACACGCAGGC
CTGATTAGCTGTTTATACG :  TGATTAGCTGTTTATACGC
TGCGTACGCGTCTGTTTGT :  GCGTACGCGTCTGTTTGTT
AGTTGCGCAGCCCAGTGGA :  GTTGCGCAGCCCAGTGGAA
CTACCGACAAACGATACCA :  TACCGACAAACGATACCAG
CGTTGGCGAAGGGTCTGAA :  GTTGGCGAAGGGTCTGAAG
CTCTAACAAGTTCTGTACC :  TCTAACAAGTTCTGTACCT
AATAAGCACGGGTAGCGGG :  ATAAGCACGGGTAGCGGGG
GTTTGCAGTATGATGCTTA :  TTTGCAGTATGATGCTTAT
ATAGTAGGCCAGGCTTAAC :  TAGTAGGCCAGGCTTAACT
AGAGCGCAGCGCGCAGGTC :  GAGCGCAGCGCGCAGGTCC
GAGATCAACTGCTCGATCC :  AGATCAACTGCTCGATCCT
TTTGGAACGATCATTGCAT :  TTGGAACGATCATTGCATC
TCAGCGAAATTCAGGGGCA :  CAGCGAAATTCAGGGGCAC
TCTTCGCGGCAAGTACAAA :  CTTCGCGGCAAGTACAAAG
GCGCGCAGGTCCCTTCGCA :  CGCGCAGGTCCCTTCGCAT
GTACCTACCTACGAAGCCA :  TACCTACCTACGAAGCCAT
GGTATTGCTCCACATGCGT :  GTATTGCTCCACATGCGTA
TCTAGGCGCTGGCTATCAG :  CTAGGCGCTGGCTATCAGT
ATACTAGGACAAAATAGTA :  TACTAGGACAAAATAGTAG
ATAGAGTCAGGGGGCGCTA :  TAGAGTCAGGGGGCGCTAA
TCGTTCTCACGTGTTCGAG :  CGTTCTCACGTGTTCGAGA
GGGCAAACGTCATATCCGG :  GGCAAACGTCATATCCGGT
TGACCTAATGCGGACAAGT :  GACCTAATGCGGACAAGTT
CTGAAGACACTATTAAAGT :  TGAAGACACTATTAAAGTA
CGAATCCTCCAGGTGGCAG :  GAATCCTCCAGGTGGCAGC
GTGGTATCGCCTGGTCTTG :  TGGTATCGCCTGGTCTTGC
GATGGACCATTTTCACACC :  ATGGACCATTTTCACACCA
TACCTACCGACAAACGATA :  ACCTACCGACAAACGATAC
CAGGTCCCTTCGCATCGAC :  AGGTCCCTTCGCATCGACT
CAGTGGAATTTGGAACGAG :  AGTGGAATTTGGAACGAGA AGTGGAATTTGGAACGAGA
TGTTATCAATGCCACCACT :  GTTATCAATGCCACCACTC
TGACCCTACTGCGGGCTCT :  GACCCTACTGCGGGCTCTA
TGTCTCACAAGTTCTGTAC :  GTCTCACAAGTTCTGTACC
TTCAGCGAAATTCAGGGGC :  TCAGCGAAATTCAGGGGCA
TCGGTCTCCATGCCCAAAA :  CGGTCTCCATGCCCAAAAT
GTTGTTACCTGTCTCACAA :  TTGTTACCTGTCTCACAAG
GGTTTATCAGGAGTGACCT :  GTTTATCAGGAGTGACCTA
TTAGATTCAGTCACCCGAT :  TAGATTCAGTCACCCGATG
GGTATGCCTCGGCCAACCA :  GTATGCCTCGGCCAACCAA
TGGTATTGCTCCACATGCG :  GGTATTGCTCCACATGCGT
CAGCTTGGATTTGATGGGT :  AGCTTGGATTTGATGGGTG
ATCAATAAGTGGGGCAAAC :  TCAATAAGTGGGGCAAACG
AGTAGACCCCTGACCACGA :  GTAGACCCCTGACCACGAC
AGCGCCCGTACTACGAGTT :  GCGCCCGTACTACGAGTTG
CGGACAAGTTCTGTACCTA :  GGACAAGTTCTGTACCTAC
GTTGTCAATATTCAGCGAA :  TTGTCAATATTCAGCGAAA
GTCTCGCGTACAAGCAGGC :  TCTCGCGTACAAGCAGGCT
ACAAGCCTCAGAGCATTAG :  CAAGCCTCAGAGCATTAGA
GCGCAGGTCCCTTCGCATC :  CGCAGGTCCCTTCGCATCG
GTCTGTTTGTTGAGGTGCT :  TCTGTTTGTTGAGGTGCTT
TTATAGAGTCAGGGGGCGC :  TATAGAGTCAGGGGGCGCT
GACCCTACTGCGGGCTCTA :  ACCCTACTGCGGGCTCTAA
CTCCTTGAGATGGGATCGG :  TCCTTGAGATGGGATCGGT
CGCGTCTGTTTGTTGAGGT :  GCGTCTGTTTGTTGAGGTG
AGGCACCTTGACGAGACCG :  GGCACCTTGACGAGACCGT
TTATGAGGCCTGGATTCAC :  TATGAGGCCTGGATTCACA
TTCATGTCTAGGCGCTGGC :  TCATGTCTAGGCGCTGGCT
CTGGGTACAATTTCGTTCT :  TGGGTACAATTTCGTTCTC
ATCATAGTGAGGGGGCTCA :  TCATAGTGAGGGGGCTCAT
TGTGGCCTTATCTAGACCG :  GTGGCCTTATCTAGACCGT
GACCTAATGCGGACAAGTT :  ACCTAATGCGGACAAGTTC
AAGCTGTGTGGTATTGCTC :  AGCTGTGTGGTATTGCTCC
ACTTGACTACCACTTGTGG :  CTTGACTACCACTTGTGGG
AACCGGATCGTTAAAGGGG :  ACCGGATCGTTAAAGGGGC
CTGTGTGGTATTGCTCCAC :  TGTGTGGTATTGCTCCACA
ACGCCGATGAGGTGGTACA :  CGCCGATGAGGTGGTACAT
CTAGACCGTTGAACCGGAT :  TAGACCGTTGAACCGGATC
ATTTGGAACGAATCCTCCA :  TTTGGAACGAATCCTCCAG
GACACGATGGACCATTTTC :  ACACGATGGACCATTTTCA
GATTTGTCCCTGAACGCTG :  ATTTGTCCCTGAACGCTGC
CGATGACCGGGGACACATA :  GATGACCGGGGACACATAC
TTCTGTACCTACCAGTTGC :  TCTGTACCTACCAGTTGCG
TTTTCAAGGTTGGCCAAAT :  TTTCAAGGTTGGCCAAATA
CGCCCGCAAGATGTCCACG :  GCCCGCAAGATGTCCACGC
TAACTCACGATAGTCGAAG :  AACTCACGATAGTCGAAGT
GCAACTCGGCGCGGTATCA :  CAACTCGGCGCGGTATCAC
CGTACCAGAGGTTGTCCGT :  GTACCAGAGGTTGTCCGTG
CAAGAGAGCGCAGCGCGCA :  AAGAGAGCGCAGCGCGCAG
GTGCCAATGATTGTGCGGT :  TGCCAATGATTGTGCGGTG
TCAAGGTTCTCCTCAGCTT :  CAAGGTTCTCCTCAGCTTA
CGGATTGAGCGCGGAGATT :  GGATTGAGCGCGGAGATTT
GGCTCGGCCTTTCCTCCGG :  GCTCGGCCTTTCCTCCGGG
GATCCTGTTAAAAAGCCCG :  ATCCTGTTAAAAAGCCCGT
TCACGTTAATAGCGTTACG :  CACGTTAATAGCGTTACGG
GACACGTAGAAGCTCTCAA :  ACACGTAGAAGCTCTCAAA
CTTATCTAGACCGTTGAAC :  TTATCTAGACCGTTGAACC
TGGAATTTGGAACGAGAAA :  GGAATTTGGAACGAGAAAG
TAGTTGTTACCTGTCTCAC :  AGTTGTTACCTGTCTCACA
CGAAGTTATAGAGTCAGGG :  GAAGTTATAGAGTCAGGGG
ACGTGTTATCAATGCCACC :  CGTGTTATCAATGCCACCA
GGCCTGGATTCACACGGTG :  GCCTGGATTCACACGGTGC
CCCGCGCCTCCCCCTCCGC :  CCGCGCCTCCCCCTCCGCC
TCTGTACCTACCGACAAAC :  CTGTACCTACCGACAAACG
CGCGTACAAGCAGGCTGGG :  GCGTACAAGCAGGCTGGGT
GCAATGGTGATAATAAGCA :  CAATGGTGATAATAAGCAC
GGGCGCTAAGGATCCGCAA :  GGCGCTAAGGATCCGCAAT
GTTATAGAGTCAGGGGGCG :  TTATAGAGTCAGGGGGCGC
CAAGCCTCAGAGCATTAGA :  AAGCCTCAGAGCATTAGAA
GTGGACACGATGGACCATT :  TGGACACGATGGACCATTT
GGTGTGCAGCGAGTGTGTA :  GTGTGCAGCGAGTGTGTAT
GTTAGATTCAGTCACCCGA :  TTAGATTCAGTCACCCGAT
AGGCTGGGTACAATTTCGT :  GGCTGGGTACAATTTCGTT
CGCTGCATCATAGTGAGGG :  GCTGCATCATAGTGAGGGG
GGCCAACCAAAAGCTGTGT :  GCCAACCAAAAGCTGTGTG
TCACGATAGTCGAAGTTAT :  CACGATAGTCGAAGTTATA
GACTCTTATGGGCGTACCA :  ACTCTTATGGGCGTACCAG
GATTGAGCGCGGAGATTTG :  ATTGAGCGCGGAGATTTGT
AGTTATAGAGTCAGGGGGC :  GTTATAGAGTCAGGGGGCG
CTGTTTATACGCCGATGAG :  TGTTTATACGCCGATGAGG
TTGAGTGTATTTTTTTCAA :  TGAGTGTATTTTTTTCAAG
ATGAAGGCTTGCCTCGGTG :  TGAAGGCTTGCCTCGGTGT
AGAAAGAGTGCCCAGTGAC :  GAAAGAGTGCCCAGTGACA
ATGGTGCACACCCGTAGAT :  TGGTGCACACCCGTAGATA
GTGTTCGAGATCAACTGCT :  TGTTCGAGATCAACTGCTC
GTACAATTTCGTTCTCACG :  TACAATTTCGTTCTCACGT
GTTGCGCAGCCCAGTGGAA :  TTGCGCAGCCCAGTGGAAT
CAGTTGTCAATATTCAGCG :  AGTTGTCAATATTCAGCGA
ACTTGTGGGACCTTTAACC :  CTTGTGGGACCTTTAACCC
CACACGGTGCGTGATACAC :  ACACGGTGCGTGATACACG
GCCTCGGTGTCTCGCGTAC :  CCTCGGTGTCTCGCGTACA
AAAGACGTGAATAGAACTC :  AAGACGTGAATAGAACTCC
TGAACTGGTACTGCTGGCC :  GAACTGGTACTGCTGGCCG
GGGCACCCGCTAATCGCGT :  GGCACCCGCTAATCGCGTT
CGCTGTTCGGCCTGCCGAG :  GCTGTTCGGCCTGCCGAGT
CTAGCATGCTGCAACTCGG :  TAGCATGCTGCAACTCGGC
CACGTTAATAGCGTTACGG :  ACGTTAATAGCGTTACGGT
AGGGGAGTGAGCGTGAACG :  GGGGAGTGAGCGTGAACGG
CAAGATGTCCACGCCGTTG :  AAGATGTCCACGCCGTTGA
AACCTGAGCTATCCCTCGC :  ACCTGAGCTATCCCTCGCG
GTACGCGTCTGTTTGTTGA :  TACGCGTCTGTTTGTTGAG
CTTAGGAGTAGGTATCCAA :  TTAGGAGTAGGTATCCAAC
TGCAGTTGTCAATATTCAG :  GCAGTTGTCAATATTCAGC
TCTTTGCTGGCGTTTAGTG :  CTTTGCTGGCGTTTAGTGG
CCCCCGACGTTGGCGAAGG :  CCCCGACGTTGGCGAAGGG
GTACAAGCAGGCTGGGTAC :  TACAAGCAGGCTGGGTACA
ACCCTTTCCGGGTAGCTGA :  CCCTTTCCGGGTAGCTGAC
GCCCGATCCAAGACAATGG :  CCCGATCCAAGACAATGGC
GAGAACTGCATGACTGCGT :  AGAACTGCATGACTGCGTT
TGGGGCAAACGTCATATCC :  GGGGCAAACGTCATATCCG
GGTGGATTCAGTGCAATGG :  GTGGATTCAGTGCAATGGT
GGTGCATGACAATGCATAA :  GTGCATGACAATGCATAAT
CCGTGAGCCGCCGATGAAG :  CGTGAGCCGCCGATGAAGG
GGCAGCTCGGTCTCCATGC :  GCAGCTCGGTCTCCATGCC
ACTACGAGTTGTAGTCAAG :  CTACGAGTTGTAGTCAAGA
AGGACAAAATAGTAGGCCA :  GGACAAAATAGTAGGCCAG
TGGGCGTACCAGAGGTTGT :  GGGCGTACCAGAGGTTGTC
TTTTTTCAAGGTTGGCCAA :  TTTTTCAAGGTTGGCCAAA
AAAGGATCGCTGTTCGGCC :  AAGGATCGCTGTTCGGCCT
ACCCGGTATACGCGCCAGT :  CCCGGTATACGCGCCAGTG
AAAGAGTGCCCAGTGACAA :  AAGAGTGCCCAGTGACAAG
TCGTCTTGAGTTGAAGTGG :  CGTCTTGAGTTGAAGTGGA
GTTTAGTGGCGGATTGAGC :  TTTAGTGGCGGATTGAGCG
AAGTTCTGTACCTACCCGG :  AGTTCTGTACCTACCCGGT
GCGAAGGGTCTGAAGACAC :  CGAAGGGTCTGAAGACACT
GAAGGCTTGCCTCGGTGTC :  AAGGCTTGCCTCGGTGTCT
CACACCCGTAGATACTACA :  ACACCCGTAGATACTACAA
GGCTTAACTTGACTACCAC :  GCTTAACTTGACTACCACT
ATGACTGCGTTTACCCTTT :  TGACTGCGTTTACCCTTTC
TGCCCAGTGACAAGCCTCA :  GCCCAGTGACAAGCCTCAG
CTGTACCTACCAGTTGCGC :  TGTACCTACCAGTTGCGCA
GGGCAATGGTGCACACCCG :  GGCAATGGTGCACACCCGT
ATTCCGTTGTAGTCCAATA :  TTCCGTTGTAGTCCAATAC
GCTCGGTCTCCATGCCCAA :  CTCGGTCTCCATGCCCAAA
CTGCCGAGTTCCAGCTTGG :  TGCCGAGTTCCAGCTTGGA
CTATGGTTTCTTCGCGGCA :  TATGGTTTCTTCGCGGCAA
ATCAATGCCACCACTCGGT :  TCAATGCCACCACTCGGTA
GTCTGGTAACAAAGCCTTT :  TCTGGTAACAAAGCCTTTT
ATGCTTATTCCAGTGTGCG :  TGCTTATTCCAGTGTGCGT
CTCACGTTAATAGCGTTAC :  TCACGTTAATAGCGTTACG
GAGTAGGTATCCAACCAAC :  AGTAGGTATCCAACCAACA
TGGTATCGCCTGGTCTTGC :  GGTATCGCCTGGTCTTGCA
TAAAAAAGACGTGAATAGA :  AAAAAAGACGTGAATAGAA
CGATACCAGTGGAATTTGG :  GATACCAGTGGAATTTGGA
AGACAATGGCCTGAACTGG :  GACAATGGCCTGAACTGGT
AAATTCAGGGGCACCCGCT :  AATTCAGGGGCACCCGCTA
TAACCCCCGACGTTGGCGA :  AACCCCCGACGTTGGCGAA
GTCTAGGCGCTGGCTATCA :  TCTAGGCGCTGGCTATCAG
ATTGCTCCACATGCGTACG :  TTGCTCCACATGCGTACGC
GGGCAGGGCAATGGTGCAC :  GGCAGGGCAATGGTGCACA
CGCAAGATGTCCACGCCGT :  GCAAGATGTCCACGCCGTT
CTTTCCTCCGGGCTCAAGA :  TTTCCTCCGGGCTCAAGAG
CTAATGCGGACAAGTTCTG :  TAATGCGGACAAGTTCTGT
TTCAAAGGATCGCTGTTCG :  TCAAAGGATCGCTGTTCGG
CGCTGGCTATCAGTATTCG :  GCTGGCTATCAGTATTCGC
CATCGGCCTTGTGGCCTTA :  ATCGGCCTTGTGGCCTTAT
ACACTATTAAAGTAGACCC :  CACTATTAAAGTAGACCCC
GCTATCAGTATTCGCCGGA :  CTATCAGTATTCGCCGGAA
ATCGTTTGGACACGTAGAA :  TCGTTTGGACACGTAGAAG
AGGCAAGTTTCATGTCTAG :  GGCAAGTTTCATGTCTAGG
TGCACTACCCACCCGATAT :  GCACTACCCACCCGATATA
GAGTGACCTAATGCGGACA :  AGTGACCTAATGCGGACAA
TGAACGGTGCCGAATGCAT :  GAACGGTGCCGAATGCATT
AAAATAGTAGGCCAGGCTT :  AAATAGTAGGCCAGGCTTA
CCCTCCGCCCGCAAGATGT :  CCTCCGCCCGCAAGATGTC
ATACTACAAGTTCTGTACC :  TACTACAAGTTCTGTACCT
CACTTGTGGGACCTTTAAC :  ACTTGTGGGACCTTTAACC
TCGCCGGAAATGGCTCGGC :  CGCCGGAAATGGCTCGGCC
GGGCTATTATGATTACATC :  GGCTATTATGATTACATCA
GCAGGGCAATGGTGCACAC :  CAGGGCAATGGTGCACACC
ACCCGTAGATACTACAAGT :  CCCGTAGATACTACAAGTT
CTGACCACGACCATGGTTT :  TGACCACGACCATGGTTTG
AGCATTAGAAGGTGGCTCG :  GCATTAGAAGGTGGCTCGT
ACCCTAGGGGAGTGAGCGT :  CCCTAGGGGAGTGAGCGTG
CTCGCGTACAAGCAGGCTG :  TCGCGTACAAGCAGGCTGG
TGAGGTGCTTAAGAGCGCC :  GAGGTGCTTAAGAGCGCCC
AGCGTGAACGGTGCCGAAT :  GCGTGAACGGTGCCGAATG
TACCTACGAAGCCATCCAG :  ACCTACGAAGCCATCCAGT
GGCCTTGTGGCCTTATCTA :  GCCTTGTGGCCTTATCTAG
GTACCAGAGGTTGTCCGTG :  TACCAGAGGTTGTCCGTGA
GCATGACTGCGTTTACCCT :  CATGACTGCGTTTACCCTT
CGTGAATAGAACTCCTTGA :  GTGAATAGAACTCCTTGAG
TCTTGCAGTTGTCAATATT :  CTTGCAGTTGTCAATATTC
ACCCACCCGATATACAGTT :  CCCACCCGATATACAGTTT
CACGACCATGGTTTGCAGT :  ACGACCATGGTTTGCAGTA
TACCCGGTATACGCGCCAG :  ACCCGGTATACGCGCCAGT
CCCAATCGCGTAGACTTAC :  CCAATCGCGTAGACTTACG
GAATTTGGAACGAGAAAGA :  AATTTGGAACGAGAAAGAG
CTCTCAAAGCCGCACCCGC :  TCTCAAAGCCGCACCCGCG
ATTCAGCGAAATTCAGGGG :  TTCAGCGAAATTCAGGGGC
ACTGCGTTTACCCTTTCCG :  CTGCGTTTACCCTTTCCGG
TAACTTGACTACCACTTGT :  AACTTGACTACCACTTGTG
CGGCCAACCAAAAGCTGTG :  GGCCAACCAAAAGCTGTGT
GGGGGACCAGAAGGCATAA :  GGGGACCAGAAGGCATAAA
GCGCCAGTGGAATTTGGAA :  CGCCAGTGGAATTTGGAAC
AGTGCAATGGTGATAATAA :  GTGCAATGGTGATAATAAG
ATGGCTCGGCCTTTCCTCC :  TGGCTCGGCCTTTCCTCCG
CCCGATCCAAGACAATGGC :  CCGATCCAAGACAATGGCC
CCAACCAAAAGCTGTGTGG :  CAACCAAAAGCTGTGTGGT
CGCCTCCCCCTCCGCCCGC :  GCCTCCCCCTCCGCCCGCA
GCCCGCAAGATGTCCACGC :  CCCGCAAGATGTCCACGCC
GGTGGCTCGTCGGCGAAGT :  GTGGCTCGTCGGCGAAGTA
TGCCTCGGTGTCTCGCGTA :  GCCTCGGTGTCTCGCGTAC
ACATCAATAAGTGGGGCAA :  CATCAATAAGTGGGGCAAA
GCTTTGCACTACCCACCCG :  CTTTGCACTACCCACCCGA
AAAAGACGTGAATAGAACT :  AAAGACGTGAATAGAACTC
TACGCGCCAGTGGAATTTG :  ACGCGCCAGTGGAATTTGG
AACCCCCGACGTTGGCGAA :  ACCCCCGACGTTGGCGAAG
GCGTTTAACGGCTTTGCAC :  CGTTTAACGGCTTTGCACT
TCACACCAATTCCGTTGTA :  CACACCAATTCCGTTGTAG
GCCCAATCGCGTAGACTTA :  CCCAATCGCGTAGACTTAC
GGTGCCGAATGCATTTTAT :  GTGCCGAATGCATTTTATG
TAACAAGTTCTGTACCTAC :  AACAAGTTCTGTACCTACC
CCTTGTGGCCTTATCTAGA :  CTTGTGGCCTTATCTAGAC
CTCGTCGGCGAAGTAATAA :  TCGTCGGCGAAGTAATAAA
GTTCCAGCTTGGATTTGAT :  TTCCAGCTTGGATTTGATG
TGCATGACAATGCATAATG :  GCATGACAATGCATAATGG
CGGTAGAATAACTCCCACG :  GGTAGAATAACTCCCACGT
CACGTAGAAGCTCTCAAAG :  ACGTAGAAGCTCTCAAAGC
AGGGGCTATTATGATTACA :  GGGGCTATTATGATTACAT
GAGGTGGTACATCCTTGGA :  AGGTGGTACATCCTTGGAG
CTACTGCGGGCTCTAACAA :  TACTGCGGGCTCTAACAAG
TATCTAGACCGTTGAACCG :  ATCTAGACCGTTGAACCGG
CGTGTTATCAATGCCACCA :  GTGTTATCAATGCCACCAC
CGAGGTGTGCAGCGAGTGT :  GAGGTGTGCAGCGAGTGTG
TTCAGGGGCACCCGCTAAT :  TCAGGGGCACCCGCTAATC
CTCTTATGGGCGTACCAGA :  TCTTATGGGCGTACCAGAG
GTGCTTAAGAGCGCCCGTA :  TGCTTAAGAGCGCCCGTAC
CGGCCTTGTGGCCTTATCT :  GGCCTTGTGGCCTTATCTA
CCAATCGCGTAGACTTACG :  CAATCGCGTAGACTTACGT
TTCAGACACCTCAGTCACA :  TCAGACACCTCAGTCACAC
AATTTCGTTCTCACGTGTT :  ATTTCGTTCTCACGTGTTC
TGAGGTGGATTCAGTGCAA :  GAGGTGGATTCAGTGCAAT
TTTTGTAGTTCACCCTAGG :  TTTGTAGTTCACCCTAGGG
AAGCCCGTGATGTGCGAGG :  AGCCCGTGATGTGCGAGGT
TTATACGCCGATGAGGTGG :  TATACGCCGATGAGGTGGT
TAGTGAGGGGGCTCATATC :  AGTGAGGGGGCTCATATCA
TAAGTGGGGCAAACGTCAT :  AAGTGGGGCAAACGTCATA
AGCCCGATCCAAGACAATG :  GCCCGATCCAAGACAATGG
CTGTCTCACAAGTTCTGTA :  TGTCTCACAAGTTCTGTAC
TTGCCTCGGTGTCTCGCGT :  TGCCTCGGTGTCTCGCGTA
GTTGGCCAAATAATCAGGT :  TTGGCCAAATAATCAGGTG
GCTTGAGTGTATTTTTTTC :  CTTGAGTGTATTTTTTTCA
TTTGTTGAGGTGCTTAAGA :  TTGTTGAGGTGCTTAAGAG
AACGAATCCTCCAGGTGGC :  ACGAATCCTCCAGGTGGCA
CGCAGCCCAGTGGAATTTG :  GCAGCCCAGTGGAATTTGG
AACTCGGCGCGGTATCACT :  ACTCGGCGCGGTATCACTG
ACACCAATTCCGTTGTAGT :  CACCAATTCCGTTGTAGTC
CTGACCCTACTGCGGGCTC :  TGACCCTACTGCGGGCTCT
CCGACGTTGGCGAAGGGTC :  CGACGTTGGCGAAGGGTCT
AAGACACTATTAAAGTAGA :  AGACACTATTAAAGTAGAC
TAGCGTTACGGTTTATCAG :  AGCGTTACGGTTTATCAGG
GATATACAGTTTCAAAGGA :  ATATACAGTTTCAAAGGAT
CACCCGTAGATACTACAAG :  ACCCGTAGATACTACAAGT
CCCGTGATGTGCGAGGTGT :  CCGTGATGTGCGAGGTGTG
ATACGTATGGTTCAGACAC :  TACGTATGGTTCAGACACC
ATGAGGTGGTACATCCTTG :  TGAGGTGGTACATCCTTGG
TTCTGTACCTACCGACAAA :  TCTGTACCTACCGACAAAC
CAGCCCAGTGGAATTTGGA :  AGCCCAGTGGAATTTGGAA
TTAGTGGCGGATTGAGCGC :  TAGTGGCGGATTGAGCGCG
TTGAACCGGATCGTTAAAG :  TGAACCGGATCGTTAAAGG
GTTAAAGGGGCTATTATGA :  TTAAAGGGGCTATTATGAT
CTTGTGGCCTTATCTAGAC :  TTGTGGCCTTATCTAGACC
CTTGACTACCACTTGTGGG :  TTGACTACCACTTGTGGGA
AACGATCATTGCATCGGCC :  ACGATCATTGCATCGGCCT
TACCTACCAGTTGCGCAGC :  ACCTACCAGTTGCGCAGCC
GTGGCGGATTGAGCGCGGA :  TGGCGGATTGAGCGCGGAG
TTGTAGTCAAGAGAGCCCG :  TGTAGTCAAGAGAGCCCGA
TGTTCGGCCTGCCGAGTTC :  GTTCGGCCTGCCGAGTTCC
GTGGATTCAGTGCAATGGT :  TGGATTCAGTGCAATGGTG
GGTTCTCCTCAGCTTAGGA :  GTTCTCCTCAGCTTAGGAG
CGCCCGTACTACGAGTTGT :  GCCCGTACTACGAGTTGTA
TTCAGTCACCCGATGACCG :  TCAGTCACCCGATGACCGG
GGACCATTTTCACACCAAT :  GACCATTTTCACACCAATT
GCCTGGATTCACACGGTGC :  CCTGGATTCACACGGTGCG
ATCCAAGACAATGGCCTGA :  TCCAAGACAATGGCCTGAA
GCACTACCCACCCGATATA :  CACTACCCACCCGATATAC
GAGAGCGCAGCGCGCAGGT :  AGAGCGCAGCGCGCAGGTC
ATGATTAACTCACGATAGT :  TGATTAACTCACGATAGTC
TCTATGGTTTCTTCGCGGC :  CTATGGTTTCTTCGCGGCA
TACGAAAGACACTGTCTGG :  ACGAAAGACACTGTCTGGT
GAGAATCTATGGTTTCTTC :  AGAATCTATGGTTTCTTCG
CGTCATATCCGGTGCATGA :  GTCATATCCGGTGCATGAC
AGAGAACTGCATGACTGCG :  GAGAACTGCATGACTGCGT
GATGGGATCGGTAGAATAA :  ATGGGATCGGTAGAATAAC
TACAGTTTCAAAGGATCGC :  ACAGTTTCAAAGGATCGCT
TTGAAGTGGACACGATGGA :  TGAAGTGGACACGATGGAC
AATAGAACTCCTTGAGATG :  ATAGAACTCCTTGAGATGG
ATCGCGTTTAACGGCTTTG :  TCGCGTTTAACGGCTTTGC
TGGCCGTGGCATTAGTTGT :  GGCCGTGGCATTAGTTGTT
GCGCTGGCTATCAGTATTC :  CGCTGGCTATCAGTATTCG
TACCAGAGGTTGTCCGTGA :  ACCAGAGGTTGTCCGTGAG
GGAGATTTGAGGTGGATTC :  GAGATTTGAGGTGGATTCA
ACCAATTCCGTTGTAGTCC :  CCAATTCCGTTGTAGTCCA
TCCGCAATCATCGCCCAAT :  CCGCAATCATCGCCCAATC
CTCGCGCGACTCACGTTAA :  TCGCGCGACTCACGTTAAT
AGTCAGGGGGCGCTAAGGA :  GTCAGGGGGCGCTAAGGAT
GCATGCTGCAACTCGGCGC :  CATGCTGCAACTCGGCGCG
CCGATGAGGTGGTACATCC :  CGATGAGGTGGTACATCCT
TTTGTCCCTGAACGCTGCA :  TTGTCCCTGAACGCTGCAT
CTCCAGGTGGCAGCTCGGT :  TCCAGGTGGCAGCTCGGTC
AGCTCTCAAAGCCGCACCC :  GCTCTCAAAGCCGCACCCG
GTGGGACCTTTAACCCCCG :  TGGGACCTTTAACCCCCGA
GATAATAAGCACGGGTAGC :  ATAATAAGCACGGGTAGCG
GCCCGTGATGTGCGAGGTG :  CCCGTGATGTGCGAGGTGT
TAAGGATCCGCAATCATCG :  AAGGATCCGCAATCATCGC
AGTGGAATTTGGAACGAGA :  GTGGAATTTGGAACGAGAA GTGGAATTTGGAACGAGAA
TGGCCTTATCTAGACCGTT :  GGCCTTATCTAGACCGTTG
AGCATGCTGCAACTCGGCG :  GCATGCTGCAACTCGGCGC
GTTTACCCTTTCCGGGTAG :  TTTACCCTTTCCGGGTAGC
GGTGCACACCCGTAGATAC :  GTGCACACCCGTAGATACT
GCCCAAAATCGTCTTGAGT :  CCCAAAATCGTCTTGAGTT
TGGCTCGGCCTTTCCTCCG :  GGCTCGGCCTTTCCTCCGG
CTCAAAGCCGCACCCGCGC :  TCAAAGCCGCACCCGCGCC
TAATGCGGACAAGTTCTGT :  AATGCGGACAAGTTCTGTA
GCAAGTACAAAGGCAAGTT :  CAAGTACAAAGGCAAGTTT
CGACGTTGGCGAAGGGTCT :  GACGTTGGCGAAGGGTCTG
TAGACCGTTGAACCGGATC :  AGACCGTTGAACCGGATCG
ACTCTTATGGGCGTACCAG :  CTCTTATGGGCGTACCAGA
GTGTGTATCGTTTGGACAC :  TGTGTATCGTTTGGACACG
TAGAATAACTCCCACGTGT :  AGAATAACTCCCACGTGTT
TGCATTTTATGAGGCCTGG :  GCATTTTATGAGGCCTGGA
TTGGAACGAGAATCTATGG :  TGGAACGAGAATCTATGGT
CCCAAAATCGTCTTGAGTT :  CCAAAATCGTCTTGAGTTG
GCGCAGCCCAGTGGAATTT :  CGCAGCCCAGTGGAATTTG
TTTGGACACGTAGAAGCTC :  TTGGACACGTAGAAGCTCT
ACCTACCCGGTATACGCGC :  CCTACCCGGTATACGCGCC
GATGAAGGCTTGCCTCGGT :  ATGAAGGCTTGCCTCGGTG
AAGGTTCTCCTCAGCTTAG :  AGGTTCTCCTCAGCTTAGG
CGTGCCAATGATTGTGCGG :  GTGCCAATGATTGTGCGGT
ACACTGTCTGGTAACAAAG :  CACTGTCTGGTAACAAAGC
TGGAACGAGAAAGAGTGCC :  GGAACGAGAAAGAGTGCCC
GACCACGACCATGGTTTGC :  ACCACGACCATGGTTTGCA
TCTCCTCAGCTTAGGAGTA :  CTCCTCAGCTTAGGAGTAG
ACTGCTCGATCCTGTTAAA :  CTGCTCGATCCTGTTAAAA
GGCAGGGCAATGGTGCACA :  GCAGGGCAATGGTGCACAC
ATTCCAGTGTGCGTCTTTG :  TTCCAGTGTGCGTCTTTGC
TTAAAGGGGCTATTATGAT :  TAAAGGGGCTATTATGATT
TACTACTAGCATGCTGCAA :  ACTACTAGCATGCTGCAAC
TGAGCGCGGAGATTTGTCC :  GAGCGCGGAGATTTGTCCC
TAGTCGAAGTTATAGAGTC :  AGTCGAAGTTATAGAGTCA
GCTGGCCGTGGCATTAGTT :  CTGGCCGTGGCATTAGTTG
GGATTGAGCGCGGAGATTT :  GATTGAGCGCGGAGATTTG
ATCGCCCAATCGCGTAGAC :  TCGCCCAATCGCGTAGACT
GTATGCCTCGGCCAACCAA :  TATGCCTCGGCCAACCAAA
GCTCAAGAGAGCGCAGCGC :  CTCAAGAGAGCGCAGCGCG
GGGGCTCATATCATCCGAC :  GGGCTCATATCATCCGACT
GCCGATGAAGGCTTGCCTC :  CCGATGAAGGCTTGCCTCG
AGAGCATTAGAAGGTGGCT :  GAGCATTAGAAGGTGGCTC
GGCAATGGTGCACACCCGT :  GCAATGGTGCACACCCGTA
CGCCGTTGACCGTGTTAGA :  GCCGTTGACCGTGTTAGAG
AGACCGTTGAACCGGATCG :  GACCGTTGAACCGGATCGT
GCACACCCGTAGATACTAC :  CACACCCGTAGATACTACA
ATACGCCGATGAGGTGGTA :  TACGCCGATGAGGTGGTAC
CGTTTAACGGCTTTGCACT :  GTTTAACGGCTTTGCACTA
CTCAGCTTAGGAGTAGGTA :  TCAGCTTAGGAGTAGGTAT
ATACAGTTTCAAAGGATCG :  TACAGTTTCAAAGGATCGC
GCCTCCCCCTCCGCCCGCA :  CCTCCCCCTCCGCCCGCAA
TCGCGTTTAACGGCTTTGC :  CGCGTTTAACGGCTTTGCA
CAGTGGAATTTGGAACGAT :  AGTGGAATTTGGAACGATC
GAATAACTCCCACGTGTTA :  AATAACTCCCACGTGTTAT
ACAAAGGCAAGTTTCATGT :  CAAAGGCAAGTTTCATGTC
GTGGAATTTGGAACGATCA :  TGGAATTTGGAACGATCAT
TCCGGGTAGCTGACCCTAC :  CCGGGTAGCTGACCCTACT
CTTAAGAGCGCCCGTACTA :  TTAAGAGCGCCCGTACTAC
AGGTGCTTAAGAGCGCCCG :  GGTGCTTAAGAGCGCCCGT
TTAAGAGCGCCCGTACTAC :  TAAGAGCGCCCGTACTACG
TAGAGTCAGGGGGCGCTAA :  AGAGTCAGGGGGCGCTAAG
CTTTGCTGGCGTTTAGTGG :  TTTGCTGGCGTTTAGTGGC
GCTCTCAAAGCCGCACCCG :  CTCTCAAAGCCGCACCCGC
CGAGACCGTGGTATCGCCT :  GAGACCGTGGTATCGCCTG
TGAGCGTGAACGGTGCCGA :  GAGCGTGAACGGTGCCGAA
CCAGAGGTTGTCCGTGAGC :  CAGAGGTTGTCCGTGAGCC
AATTTGGAACGATCATTGC :  ATTTGGAACGATCATTGCA
ATCCTCCAGGTGGCAGCTC :  TCCTCCAGGTGGCAGCTCG
ATTAGAAGGTGGCTCGTCG :  TTAGAAGGTGGCTCGTCGG
TGTGTGGTATTGCTCCACA :  GTGTGGTATTGCTCCACAT
AGTATGATGCTTATTCCAG :  GTATGATGCTTATTCCAGT
CTTGAGATGGGATCGGTAG :  TTGAGATGGGATCGGTAGA
TGATTACATCAATAAGTGG :  GATTACATCAATAAGTGGG
AAGGATCGCTGTTCGGCCT :  AGGATCGCTGTTCGGCCTG
TGGAGATTTGAGGTGGATT :  GGAGATTTGAGGTGGATTC
CTCGGTCTCCATGCCCAAA :  TCGGTCTCCATGCCCAAAA
CTGCAACTCGGCGCGGTAT :  TGCAACTCGGCGCGGTATC
CGGGCAACCTGAGCTATCC :  GGGCAACCTGAGCTATCCC
GAAAGACACTGTCTGGTAA :  AAAGACACTGTCTGGTAAC
CAACCAACAGGGCAGGGCA :  AACCAACAGGGCAGGGCAA
TGTATTTTTTTCAAGGTTG :  GTATTTTTTTCAAGGTTGG
GAGTTGTAGTCAAGAGAGC :  AGTTGTAGTCAAGAGAGCC
GACTGATTAGCTGTTTATA :  ACTGATTAGCTGTTTATAC
AGGGGCACCCGCTAATCGC :  GGGGCACCCGCTAATCGCG
ACCTACGAAGCCATCCAGT :  CCTACGAAGCCATCCAGTG
GGTGTTAGATTCAGTCACC :  GTGTTAGATTCAGTCACCC
CATGACTGCGTTTACCCTT :  ATGACTGCGTTTACCCTTT
TAGAACTCCTTGAGATGGG :  AGAACTCCTTGAGATGGGA
CCTACCCGGTATACGCGCC :  CTACCCGGTATACGCGCCA
AAGACGTGAATAGAACTCC :  AGACGTGAATAGAACTCCT
GCTGACCCTACTGCGGGCT :  CTGACCCTACTGCGGGCTC
GTAGAAGCTCTCAAAGCCG :  TAGAAGCTCTCAAAGCCGC
TAATAAGCACGGGTAGCGG :  AATAAGCACGGGTAGCGGG
TACTCAGCTTGAGTGTATT :  ACTCAGCTTGAGTGTATTT
AGTTCTGTACCTACCCGGT :  GTTCTGTACCTACCCGGTA
TGCGCAGCCCAGTGGAATT :  GCGCAGCCCAGTGGAATTT
TCCAATACGTATGGTTCAG :  CCAATACGTATGGTTCAGA
GAAAGAGTGCCCAGTGACA :  AAAGAGTGCCCAGTGACAA
CCCAGTGACAAGCCTCAGA :  CCAGTGACAAGCCTCAGAG
GGAATTTGGAACGATCATT :  GAATTTGGAACGATCATTG
AACGGCTTTGCACTACCCA :  ACGGCTTTGCACTACCCAC
GCTGCAACTCGGCGCGGTA :  CTGCAACTCGGCGCGGTAT
GGCAAACGTCATATCCGGT :  GCAAACGTCATATCCGGTG
GCGCAGCGCGCAGGTCCCT :  CGCAGCGCGCAGGTCCCTT
TACACGCAGGCACCTTGAC :  ACACGCAGGCACCTTGACG
TGTCTCGCGTACAAGCAGG :  GTCTCGCGTACAAGCAGGC
GTGGTACATCCTTGGAGAT :  TGGTACATCCTTGGAGATT
TGGAATATACTACTAGCAT :  GGAATATACTACTAGCATG
TACCAGTGGAATTTGGAAC :  ACCAGTGGAATTTGGAACG
ACCTTGACGAGACCGTGGT :  CCTTGACGAGACCGTGGTA
CGAGATCAACTGCTCGATC :  GAGATCAACTGCTCGATCC
TATCATCCGACTCTTATGG :  ATCATCCGACTCTTATGGG
ATTCAGGGGCACCCGCTAA :  TTCAGGGGCACCCGCTAAT
TACGCCGATGAGGTGGTAC :  ACGCCGATGAGGTGGTACA
CATGGTTTGCAGTATGATG :  ATGGTTTGCAGTATGATGC
ACTCCCCGGGCGGCGGGCA :  CTCCCCGGGCGGCGGGCAA
TGTGGGACCTTTAACCCCC :  GTGGGACCTTTAACCCCCG
ATTCGCCGGAAATGGCTCG :  TTCGCCGGAAATGGCTCGG
CGCGTAGACTTACGTGGAA :  GCGTAGACTTACGTGGAAT
ACCTACCGACAAACGATAC :  CCTACCGACAAACGATACC
CGCTAAGGATCCGCAATCA :  GCTAAGGATCCGCAATCAT
TACTACAAGTTCTGTACCT :  ACTACAAGTTCTGTACCTA
GTAGTTCACCCTAGGGGAG :  TAGTTCACCCTAGGGGAGT
GAACGCTGCATCATAGTGA :  AACGCTGCATCATAGTGAG
AAGTAGACCCCTGACCACG :  AGTAGACCCCTGACCACGA
ATGCGTACGCGTCTGTTTG :  TGCGTACGCGTCTGTTTGT
CATAAACTCCCCGGGCGGC :  ATAAACTCCCCGGGCGGCG
CATCCTTGGAGATTTGAGG :  ATCCTTGGAGATTTGAGGT
GTTAAAAAGCCCGTGATGT :  TTAAAAAGCCCGTGATGTG
AACCAAAAGCTGTGTGGTA :  ACCAAAAGCTGTGTGGTAT
CTGGCGTTTAGTGGCGGAT :  TGGCGTTTAGTGGCGGATT
CAGGCTTAACTTGACTACC :  AGGCTTAACTTGACTACCA
GAGATTTGTCCCTGAACGC :  AGATTTGTCCCTGAACGCT
TTCACACCAATTCCGTTGT :  TCACACCAATTCCGTTGTA
TGACCGTGTTAGAGAACTG :  GACCGTGTTAGAGAACTGC
TTATGGGCGTACCAGAGGT :  TATGGGCGTACCAGAGGTT
AGTGCCCAGTGACAAGCCT :  GTGCCCAGTGACAAGCCTC
TTCGGCCTGCCGAGTTCCA :  TCGGCCTGCCGAGTTCCAG
GATACCAGTGGAATTTGGA :  ATACCAGTGGAATTTGGAA
AAGCCTCAGAGCATTAGAA :  AGCCTCAGAGCATTAGAAG
GACCATTTTCACACCAATT :  ACCATTTTCACACCAATTC
ATGGGCGTACCAGAGGTTG :  TGGGCGTACCAGAGGTTGT
TTTTTCAAGGTTGGCCAAA :  TTTTCAAGGTTGGCCAAAT
ATCGGTAGAATAACTCCCA :  TCGGTAGAATAACTCCCAC
GTGGTATTGCTCCACATGC :  TGGTATTGCTCCACATGCG
CCCGATATACAGTTTCAAA :  CCGATATACAGTTTCAAAG
GAGTGTATTTTTTTCAAGG :  AGTGTATTTTTTTCAAGGT
CGACTCACGTTAATAGCGT :  GACTCACGTTAATAGCGTT
TGAAGACACTATTAAAGTA :  GAAGACACTATTAAAGTAG
CCGCAAGATGTCCACGCCG :  CGCAAGATGTCCACGCCGT
ACCCGCGCCTCCCCCTCCG :  CCCGCGCCTCCCCCTCCGC
CCCCCTCCGCCCGCAAGAT :  CCCCTCCGCCCGCAAGATG
TCATGTCTAGGCGCTGGCT :  CATGTCTAGGCGCTGGCTA
AACAGGGCAGGGCAATGGT :  ACAGGGCAGGGCAATGGTG
CGCGCAGGTCCCTTCGCAT :  GCGCAGGTCCCTTCGCATC
TGACCGGGGACACATACTA :  GACCGGGGACACATACTAG
TTCTTCGCGGCAAGTACAA :  TCTTCGCGGCAAGTACAAA
CTGAACGCTGCATCATAGT :  TGAACGCTGCATCATAGTG
TTGTGCGGTGTATGATTAA :  TGTGCGGTGTATGATTAAC
CGAGTTGTAGTCAAGAGAG :  GAGTTGTAGTCAAGAGAGC
CGAGTGTGTATCGTTTGGA :  GAGTGTGTATCGTTTGGAC
GGAACGAGAATCTATGGTT :  GAACGAGAATCTATGGTTT
TCCAGTGGAATTTGGAACG :  CCAGTGGAATTTGGAACGA
TTAACGGCTTTGCACTACC :  TAACGGCTTTGCACTACCC
GCGTACCAGAGGTTGTCCG :  CGTACCAGAGGTTGTCCGT
CTTCGCATCGACTGATTAG :  TTCGCATCGACTGATTAGC
GTGTGCGTCTTTGCTGGCG :  TGTGCGTCTTTGCTGGCGT
GTGCCGAATGCATTTTATG :  TGCCGAATGCATTTTATGA
CTGCTGGCCGTGGCATTAG :  TGCTGGCCGTGGCATTAGT
TTGCATCGGCCTTGTGGCC :  TGCATCGGCCTTGTGGCCT
TCAGTCACACCGTGCCAAT :  CAGTCACACCGTGCCAATG
GGCGTTTAGTGGCGGATTG :  GCGTTTAGTGGCGGATTGA
TATGGGCGTACCAGAGGTT :  ATGGGCGTACCAGAGGTTG
ACACCGTGCCAATGATTGT :  CACCGTGCCAATGATTGTG
ATTTGATGGGTGTGGTATG :  TTTGATGGGTGTGGTATGC
AGTTGTTACCTGTCTCACA :  GTTGTTACCTGTCTCACAA
CTTACGTGGAATATACTAC :  TTACGTGGAATATACTACT
AGTTCACCCTAGGGGAGTG :  GTTCACCCTAGGGGAGTGA
TGTGCGTCTTTGCTGGCGT :  GTGCGTCTTTGCTGGCGTT
AGGTGGCTCGTCGGCGAAG :  GGTGGCTCGTCGGCGAAGT
GCCAGTGGAATTTGGAACG :  CCAGTGGAATTTGGAACGA
GAACTCCTTGAGATGGGAT :  AACTCCTTGAGATGGGATC
CCTCCGGGCTCAAGAGAGC :  CTCCGGGCTCAAGAGAGCG
CCAGTTGCGCAGCCCAGTG :  CAGTTGCGCAGCCCAGTGG
AACGGTGCCGAATGCATTT :  ACGGTGCCGAATGCATTTT
GGAGTGACCTAATGCGGAC :  GAGTGACCTAATGCGGACA
TGGCGGATTGAGCGCGGAG :  GGCGGATTGAGCGCGGAGA
GACAAGTTCTGTACCTACC :  ACAAGTTCTGTACCTACCG
AGGAGTAGGTATCCAACCA :  GGAGTAGGTATCCAACCAA
TGCTCCACATGCGTACGCG :  GCTCCACATGCGTACGCGT
TGTTTGTTGAGGTGCTTAA :  GTTTGTTGAGGTGCTTAAG
CCTTTCCGGGTAGCTGACC :  CTTTCCGGGTAGCTGACCC
CGGGGGACCAGAAGGCATA :  GGGGGACCAGAAGGCATAA
AGTTCTGTACCTACCTACG :  GTTCTGTACCTACCTACGA
CTGGATTCACACGGTGCGT :  TGGATTCACACGGTGCGTG
GCAGCGAGTGTGTATCGTT :  CAGCGAGTGTGTATCGTTT
TGGACCATTTTCACACCAA :  GGACCATTTTCACACCAAT
TGATACACGCAGGCACCTT :  GATACACGCAGGCACCTTG
CCAACAGGGCAGGGCAATG :  CAACAGGGCAGGGCAATGG
GCACCCGCGCCTCCCCCTC :  CACCCGCGCCTCCCCCTCC
AATTCCGTTGTAGTCCAAT :  ATTCCGTTGTAGTCCAATA
TGATAATAAGCACGGGTAG :  GATAATAAGCACGGGTAGC
AGTTGAAGTGGACACGATG :  GTTGAAGTGGACACGATGG
ATGAGGCCTGGATTCACAC :  TGAGGCCTGGATTCACACG
AGCTCGGTCTCCATGCCCA :  GCTCGGTCTCCATGCCCAA
CAGGTGTTAGATTCAGTCA :  AGGTGTTAGATTCAGTCAC
CTGTTAAAAAGCCCGTGAT :  TGTTAAAAAGCCCGTGATG
TTGGAACGATCATTGCATC :  TGGAACGATCATTGCATCG
AGGAGTGACCTAATGCGGA :  GGAGTGACCTAATGCGGAC
AGTGACCTAATGCGGACAA :  GTGACCTAATGCGGACAAG
GCAATCATCGCCCAATCGC :  CAATCATCGCCCAATCGCG
CGTCTTTGCTGGCGTTTAG :  GTCTTTGCTGGCGTTTAGT
AACCAACAGGGCAGGGCAA :  ACCAACAGGGCAGGGCAAT
ACGATACCAGTGGAATTTG :  CGATACCAGTGGAATTTGG
ACCCGATGACCGGGGACAC :  CCCGATGACCGGGGACACA
TGCCAATGATTGTGCGGTG :  GCCAATGATTGTGCGGTGT
ACTACCACTTGTGGGACCT :  CTACCACTTGTGGGACCTT
CGGAAATGGCTCGGCCTTT :  GGAAATGGCTCGGCCTTTC
GGCCTGCCGAGTTCCAGCT :  GCCTGCCGAGTTCCAGCTT
TTTGATGGGTGTGGTATGC :  TTGATGGGTGTGGTATGCC
GATTTGAGGTGGATTCAGT :  ATTTGAGGTGGATTCAGTG
TTTGTAGTTCACCCTAGGG :  TTGTAGTTCACCCTAGGGG
AGTTGTCAATATTCAGCGA :  GTTGTCAATATTCAGCGAA
CTGTACCTACCGACAAACG :  TGTACCTACCGACAAACGA
GACCGGGGACACATACTAG :  ACCGGGGACACATACTAGG
CCACGCCGTTGACCGTGTT :  CACGCCGTTGACCGTGTTA
TGCATAATGGTCATACTCA :  GCATAATGGTCATACTCAG
AATAAAAAAGACGTGAATA :  ATAAAAAAGACGTGAATAG
ATGGTTTGCAGTATGATGC :  TGGTTTGCAGTATGATGCT
ATGACAATGCATAATGGTC :  TGACAATGCATAATGGTCA
CCTAGGGGAGTGAGCGTGA :  CTAGGGGAGTGAGCGTGAA
GTTTGTTGAGGTGCTTAAG :  TTTGTTGAGGTGCTTAAGA
GACTTACGTGGAATATACT :  ACTTACGTGGAATATACTA
AGGCCAGGCTTAACTTGAC :  GGCCAGGCTTAACTTGACT
TGGAATTTGGAACGAGAAT :  GGAATTTGGAACGAGAATC
GACGTTGGCGAAGGGTCTG :  ACGTTGGCGAAGGGTCTGA
ATGTCCACGCCGTTGACCG :  TGTCCACGCCGTTGACCGT
CACACCAATTCCGTTGTAG :  ACACCAATTCCGTTGTAGT
AAAGGCAAGTTTCATGTCT :  AAGGCAAGTTTCATGTCTA
CTACCCGGTATACGCGCCA :  TACCCGGTATACGCGCCAG
GAAATTCAGGGGCACCCGC :  AAATTCAGGGGCACCCGCT
GTCTTGCAGTTGTCAATAT :  TCTTGCAGTTGTCAATATT
CAATATTCAGCGAAATTCA :  AATATTCAGCGAAATTCAG
GCGGACAAGTTCTGTACCT :  CGGACAAGTTCTGTACCTA
TGTTAGAGAACTGCATGAC :  GTTAGAGAACTGCATGACT
CCGAGTTCCAGCTTGGATT :  CGAGTTCCAGCTTGGATTT
TACATCAATAAGTGGGGCA :  ACATCAATAAGTGGGGCAA
GCCGAGTTCCAGCTTGGAT :  CCGAGTTCCAGCTTGGATT
ATTAGCTGTTTATACGCCG :  TTAGCTGTTTATACGCCGA
ACTGTCTGGTAACAAAGCC :  CTGTCTGGTAACAAAGCCT
TATCCCTCGCGCGACTCAC :  ATCCCTCGCGCGACTCACG
AAGCCTTTTGTAGTTCACC :  AGCCTTTTGTAGTTCACCC
ATGCCACCACTCGGTACGA :  TGCCACCACTCGGTACGAA
AGCTTGGATTTGATGGGTG :  GCTTGGATTTGATGGGTGT
CATGCCCAAAATCGTCTTG :  ATGCCCAAAATCGTCTTGA
ACCGTTGAACCGGATCGTT :  CCGTTGAACCGGATCGTTA
TCCAGTGTGCGTCTTTGCT :  CCAGTGTGCGTCTTTGCTG
TTCCGTTGTAGTCCAATAC :  TCCGTTGTAGTCCAATACG
AGAACTCCTTGAGATGGGA :  GAACTCCTTGAGATGGGAT
ATTAACTCACGATAGTCGA :  TTAACTCACGATAGTCGAA
CCACCCGATATACAGTTTC :  CACCCGATATACAGTTTCA
GGACAAGTTCTGTACCTAC :  GACAAGTTCTGTACCTACC
GCAGTATGATGCTTATTCC :  CAGTATGATGCTTATTCCA
TCTTATGGGCGTACCAGAG :  CTTATGGGCGTACCAGAGG
GCTTATTCCAGTGTGCGTC :  CTTATTCCAGTGTGCGTCT
GGCCAAATAATCAGGTGTT :  GCCAAATAATCAGGTGTTA
CAACAGGGCAGGGCAATGG :  AACAGGGCAGGGCAATGGT
CACATGCGTACGCGTCTGT :  ACATGCGTACGCGTCTGTT
CCTGGATTCACACGGTGCG :  CTGGATTCACACGGTGCGT
GATGCTTATTCCAGTGTGC :  ATGCTTATTCCAGTGTGCG
GTACCTACCCGGTATACGC :  TACCTACCCGGTATACGCG
CCACGACCATGGTTTGCAG :  CACGACCATGGTTTGCAGT
AGTGACAAGCCTCAGAGCA :  GTGACAAGCCTCAGAGCAT
TGCTTATTCCAGTGTGCGT :  GCTTATTCCAGTGTGCGTC
CCAACCAACAGGGCAGGGC :  CAACCAACAGGGCAGGGCA
TTCTGTACCTACCTACGAA :  TCTGTACCTACCTACGAAG
GTAGACCCCTGACCACGAC :  TAGACCCCTGACCACGACC
ACACGCAGGCACCTTGACG :  CACGCAGGCACCTTGACGA
ACGCAGGCACCTTGACGAG :  CGCAGGCACCTTGACGAGA
GACTACCACTTGTGGGACC :  ACTACCACTTGTGGGACCT
TAGCTGTTTATACGCCGAT :  AGCTGTTTATACGCCGATG
AGTTCTGTACCTACCGACA :  GTTCTGTACCTACCGACAA
ACATCCTTGGAGATTTGAG :  CATCCTTGGAGATTTGAGG
ATGGTGATAATAAGCACGG :  TGGTGATAATAAGCACGGG
TCGATCCTGTTAAAAAGCC :  CGATCCTGTTAAAAAGCCC
AATAGCGTTACGGTTTATC :  ATAGCGTTACGGTTTATCA
AAGGTGGCTCGTCGGCGAA :  AGGTGGCTCGTCGGCGAAG
CTTGGAGATTTGAGGTGGA :  TTGGAGATTTGAGGTGGAT
TACCTACCCGGTATACGCG :  ACCTACCCGGTATACGCGC
CTCAAGAGAGCGCAGCGCG :  TCAAGAGAGCGCAGCGCGC
TTTGCTGGCGTTTAGTGGC :  TTGCTGGCGTTTAGTGGCG
TGGCCTGAACTGGTACTGC :  GGCCTGAACTGGTACTGCT
AATACGTATGGTTCAGACA :  ATACGTATGGTTCAGACAC
CGTTACGGTTTATCAGGAG :  GTTACGGTTTATCAGGAGT
CGGTTTATCAGGAGTGACC :  GGTTTATCAGGAGTGACCT
TGAGGTGGTACATCCTTGG :  GAGGTGGTACATCCTTGGA
GGTCCCTTCGCATCGACTG :  GTCCCTTCGCATCGACTGA
CAAGTTCTGTACCTACCTA :  AAGTTCTGTACCTACCTAC
CGCGGCAAGTACAAAGGCA :  GCGGCAAGTACAAAGGCAA
CGAGTTCCAGCTTGGATTT :  GAGTTCCAGCTTGGATTTG
GCGGCGGGCAACCTGAGCT :  CGGCGGGCAACCTGAGCTA
TCGCGTACAAGCAGGCTGG :  CGCGTACAAGCAGGCTGGG
CCGTGGTATCGCCTGGTCT :  CGTGGTATCGCCTGGTCTT
GTGCACACCCGTAGATACT :  TGCACACCCGTAGATACTA
GCGTGATACACGCAGGCAC :  CGTGATACACGCAGGCACC
CCGATCCAAGACAATGGCC :  CGATCCAAGACAATGGCCT
AAATGGCTCGGCCTTTCCT :  AATGGCTCGGCCTTTCCTC
GTTTAACGGCTTTGCACTA :  TTTAACGGCTTTGCACTAC
CAGGGGGCGCTAAGGATCC :  AGGGGGCGCTAAGGATCCG
TGGATTCACACGGTGCGTG :  GGATTCACACGGTGCGTGA
TTGTGGCCTTATCTAGACC :  TGTGGCCTTATCTAGACCG
AGTTCCAGCTTGGATTTGA :  GTTCCAGCTTGGATTTGAT
GCGAGGTGTGCAGCGAGTG :  CGAGGTGTGCAGCGAGTGT
TCCGTTGTAGTCCAATACG :  CCGTTGTAGTCCAATACGT
TGCTGGCGTTTAGTGGCGG :  GCTGGCGTTTAGTGGCGGA
CAGTTGCGCAGCCCAGTGG :  AGTTGCGCAGCCCAGTGGA
CGCCTGGTCTTGCAGTTGT :  GCCTGGTCTTGCAGTTGTC
CCTTCGCATCGACTGATTA :  CTTCGCATCGACTGATTAG
TATGGTTTCTTCGCGGCAA :  ATGGTTTCTTCGCGGCAAG
ACTCACGTTAATAGCGTTA :  CTCACGTTAATAGCGTTAC
CAAACGTCATATCCGGTGC :  AAACGTCATATCCGGTGCA
AACGATACCAGTGGAATTT :  ACGATACCAGTGGAATTTG
CTTCGCGGCAAGTACAAAG :  TTCGCGGCAAGTACAAAGG
TCGGCGAAGTAATAAAAAA :  CGGCGAAGTAATAAAAAAG
TTAGGAGTAGGTATCCAAC :  TAGGAGTAGGTATCCAACC
ACCAGAGGTTGTCCGTGAG :  CCAGAGGTTGTCCGTGAGC
CAAAGGATCGCTGTTCGGC :  AAAGGATCGCTGTTCGGCC
ATCTATGGTTTCTTCGCGG :  TCTATGGTTTCTTCGCGGC
AGCTGTGTGGTATTGCTCC :  GCTGTGTGGTATTGCTCCA
GGTGGCAGCTCGGTCTCCA :  GTGGCAGCTCGGTCTCCAT
ATCCGCAATCATCGCCCAA :  TCCGCAATCATCGCCCAAT
GTACTGCTGGCCGTGGCAT :  TACTGCTGGCCGTGGCATT
GCATGACAATGCATAATGG :  CATGACAATGCATAATGGT
CAGGAGTGACCTAATGCGG :  AGGAGTGACCTAATGCGGA
TTCCTCCGGGCTCAAGAGA :  TCCTCCGGGCTCAAGAGAG
AAAAAGACGTGAATAGAAC :  AAAAGACGTGAATAGAACT
AAAGCTGTGTGGTATTGCT :  AAGCTGTGTGGTATTGCTC
GCCAGGCTTAACTTGACTA :  CCAGGCTTAACTTGACTAC
GGCTATTATGATTACATCA :  GCTATTATGATTACATCAA
GTGGCTCGTCGGCGAAGTA :  TGGCTCGTCGGCGAAGTAA
GTCTCCATGCCCAAAATCG :  TCTCCATGCCCAAAATCGT
TAGGCCAGGCTTAACTTGA :  AGGCCAGGCTTAACTTGAC
TATACGCCGATGAGGTGGT :  ATACGCCGATGAGGTGGTA
ATTTGGAACGAGAATCTAT :  TTTGGAACGAGAATCTATG
TGATTGTGCGGTGTATGAT :  GATTGTGCGGTGTATGATT
GTCCGTGAGCCGCCGATGA :  TCCGTGAGCCGCCGATGAA
ACGAGACCGTGGTATCGCC :  CGAGACCGTGGTATCGCCT
ACGAGAATCTATGGTTTCT :  CGAGAATCTATGGTTTCTT
TGTGCGGTGTATGATTAAC :  GTGCGGTGTATGATTAACT
ATGGGTGTGGTATGCCTCG :  TGGGTGTGGTATGCCTCGG
AGATACTACAAGTTCTGTA :  GATACTACAAGTTCTGTAC
GCATTTTATGAGGCCTGGA :  CATTTTATGAGGCCTGGAT
ACATGCGTACGCGTCTGTT :  CATGCGTACGCGTCTGTTT
TGGTAACAAAGCCTTTTGT :  GGTAACAAAGCCTTTTGTA
CATCAATAAGTGGGGCAAA :  ATCAATAAGTGGGGCAAAC
TTCAAGGTTGGCCAAATAA :  TCAAGGTTGGCCAAATAAT
ACGCGTCTGTTTGTTGAGG :  CGCGTCTGTTTGTTGAGGT
TACCCACCCGATATACAGT :  ACCCACCCGATATACAGTT
ATGCATTTTATGAGGCCTG :  TGCATTTTATGAGGCCTGG
TGAGGCCTGGATTCACACG :  GAGGCCTGGATTCACACGG
GTATTGCTCCACATGCGTA :  TATTGCTCCACATGCGTAC
TCCCCGGGCGGCGGGCAAC :  CCCCGGGCGGCGGGCAACC
TTATTCCAGTGTGCGTCTT :  TATTCCAGTGTGCGTCTTT
TGCAACTCGGCGCGGTATC :  GCAACTCGGCGCGGTATCA
TCCCTCGCGCGACTCACGT :  CCCTCGCGCGACTCACGTT
CAGTATTCGCCGGAAATGG :  AGTATTCGCCGGAAATGGC
GCGCGGAGATTTGTCCCTG :  CGCGGAGATTTGTCCCTGA
GCAAGTTTCATGTCTAGGC :  CAAGTTTCATGTCTAGGCG
AAGAGAGCGCAGCGCGCAG :  AGAGAGCGCAGCGCGCAGG
GACGAGACCGTGGTATCGC :  ACGAGACCGTGGTATCGCC
ATGATTGTGCGGTGTATGA :  TGATTGTGCGGTGTATGAT
GGCTCGTCGGCGAAGTAAT :  GCTCGTCGGCGAAGTAATA
GAGGGGGCTCATATCATCC :  AGGGGGCTCATATCATCCG
TGTAGTTCACCCTAGGGGA :  GTAGTTCACCCTAGGGGAG
ATTATGATTACATCAATAA :  TTATGATTACATCAATAAG
AGTGAGCGTGAACGGTGCC :  GTGAGCGTGAACGGTGCCG
CAAGACAATGGCCTGAACT :  AAGACAATGGCCTGAACTG
CTGGTCTTGCAGTTGTCAA :  TGGTCTTGCAGTTGTCAAT
TCCAACCAACAGGGCAGGG :  CCAACCAACAGGGCAGGGC
CTCACGATAGTCGAAGTTA :  TCACGATAGTCGAAGTTAT
TGTGGTATGCCTCGGCCAA :  GTGGTATGCCTCGGCCAAC
GGTATACGCGCCAGTGGAA :  GTATACGCGCCAGTGGAAT
GAGCTATCCCTCGCGCGAC :  AGCTATCCCTCGCGCGACT
CATGACAATGCATAATGGT :  ATGACAATGCATAATGGTC
TTGAGGTGGATTCAGTGCA :  TGAGGTGGATTCAGTGCAA
TGTATCGTTTGGACACGTA :  GTATCGTTTGGACACGTAG
GGGCTCTAACAAGTTCTGT :  GGCTCTAACAAGTTCTGTA
CCGGGCGGCGGGCAACCTG :  CGGGCGGCGGGCAACCTGA
TGAATAGAACTCCTTGAGA :  GAATAGAACTCCTTGAGAT
CTACCCACCCGATATACAG :  TACCCACCCGATATACAGT
TATACAGTTTCAAAGGATC :  ATACAGTTTCAAAGGATCG
TTCGCCGGAAATGGCTCGG :  TCGCCGGAAATGGCTCGGC
CCAGGCTTAACTTGACTAC :  CAGGCTTAACTTGACTACC
CCGATGACCGGGGACACAT :  CGATGACCGGGGACACATA
GAGCCCGATCCAAGACAAT :  AGCCCGATCCAAGACAATG
CGGTACGAAAGACACTGTC :  GGTACGAAAGACACTGTCT
GGTTTCTTCGCGGCAAGTA :  GTTTCTTCGCGGCAAGTAC
GGCTTTGCACTACCCACCC :  GCTTTGCACTACCCACCCG
CCGATATACAGTTTCAAAG :  CGATATACAGTTTCAAAGG
GTTTCATGTCTAGGCGCTG :  TTTCATGTCTAGGCGCTGG
TGCGAGGTGTGCAGCGAGT :  GCGAGGTGTGCAGCGAGTG
GCTATCCCTCGCGCGACTC :  CTATCCCTCGCGCGACTCA
CCCTAGGGGAGTGAGCGTG :  CCTAGGGGAGTGAGCGTGA
TGCGGTGTATGATTAACTC :  GCGGTGTATGATTAACTCA
GTCAGGGGGCGCTAAGGAT :  TCAGGGGGCGCTAAGGATC
TTCACCCTAGGGGAGTGAG :  TCACCCTAGGGGAGTGAGC
TTTCCGGGTAGCTGACCCT :  TTCCGGGTAGCTGACCCTA
GTTAGAGAACTGCATGACT :  TTAGAGAACTGCATGACTG
CGGAGATTTGTCCCTGAAC :  GGAGATTTGTCCCTGAACG
ACGAAAGACACTGTCTGGT :  CGAAAGACACTGTCTGGTA
AGTGTGTATCGTTTGGACA :  GTGTGTATCGTTTGGACAC
AGCCCGTGATGTGCGAGGT :  GCCCGTGATGTGCGAGGTG
CAGAGGTTGTCCGTGAGCC :  AGAGGTTGTCCGTGAGCCG
GTACCTACCAGTTGCGCAG :  TACCTACCAGTTGCGCAGC
GACACCTCAGTCACACCGT :  ACACCTCAGTCACACCGTG
GCCTGCCGAGTTCCAGCTT :  CCTGCCGAGTTCCAGCTTG
CACACCGTGCCAATGATTG :  ACACCGTGCCAATGATTGT
CTTGACGAGACCGTGGTAT :  TTGACGAGACCGTGGTATC
CAGCTTGAGTGTATTTTTT :  AGCTTGAGTGTATTTTTTT
CGTCGGCGAAGTAATAAAA :  GTCGGCGAAGTAATAAAAA
GGAATTTGGAACGAATCCT :  GAATTTGGAACGAATCCTC
CATACTCAGCTTGAGTGTA :  ATACTCAGCTTGAGTGTAT
TGGTGATAATAAGCACGGG :  GGTGATAATAAGCACGGGT
TATAGAGTCAGGGGGCGCT :  ATAGAGTCAGGGGGCGCTA
GGTACAATTTCGTTCTCAC :  GTACAATTTCGTTCTCACG
TCATATCATCCGACTCTTA :  CATATCATCCGACTCTTAT
CCAAGACAATGGCCTGAAC :  CAAGACAATGGCCTGAACT
TGTCCGTGAGCCGCCGATG :  GTCCGTGAGCCGCCGATGA
TGCATCATAGTGAGGGGGC :  GCATCATAGTGAGGGGGCT
AAACTCCCCGGGCGGCGGG :  AACTCCCCGGGCGGCGGGC
TAGTCAAGAGAGCCCGATC :  AGTCAAGAGAGCCCGATCC
CATCCAGTGGAATTTGGAA :  ATCCAGTGGAATTTGGAAC
CGTTGAACCGGATCGTTAA :  GTTGAACCGGATCGTTAAA
TCAGTCACCCGATGACCGG :  CAGTCACCCGATGACCGGG
TGACAATGCATAATGGTCA :  GACAATGCATAATGGTCAT
TCCAGCTTGGATTTGATGG :  CCAGCTTGGATTTGATGGG
TATCAGTATTCGCCGGAAA :  ATCAGTATTCGCCGGAAAT
GAATCTATGGTTTCTTCGC :  AATCTATGGTTTCTTCGCG
TGTACCTACCCGGTATACG :  GTACCTACCCGGTATACGC
GCCCGTACTACGAGTTGTA :  CCCGTACTACGAGTTGTAG
CCTCAGAGCATTAGAAGGT :  CTCAGAGCATTAGAAGGTG
CGTTGTAGTCCAATACGTA :  GTTGTAGTCCAATACGTAT
GCGGGCTCTAACAAGTTCT :  CGGGCTCTAACAAGTTCTG
GATTTGATGGGTGTGGTAT :  ATTTGATGGGTGTGGTATG
TGAAGTGGACACGATGGAC :  GAAGTGGACACGATGGACC
CTAACAAGTTCTGTACCTA :  TAACAAGTTCTGTACCTAC
TGATGCTTATTCCAGTGTG :  GATGCTTATTCCAGTGTGC
GTTGTAGTCAAGAGAGCCC :  TTGTAGTCAAGAGAGCCCG
TATCAATGCCACCACTCGG :  ATCAATGCCACCACTCGGT
TCTCACAAGTTCTGTACCT :  CTCACAAGTTCTGTACCTA
ATTGCATCGGCCTTGTGGC :  TTGCATCGGCCTTGTGGCC
TCCATGCCCAAAATCGTCT :  CCATGCCCAAAATCGTCTT
AAGATGTCCACGCCGTTGA :  AGATGTCCACGCCGTTGAC
TCCAGGTGGCAGCTCGGTC :  CCAGGTGGCAGCTCGGTCT
TTCGCGGCAAGTACAAAGG :  TCGCGGCAAGTACAAAGGC
TGAGGGGGCTCATATCATC :  GAGGGGGCTCATATCATCC
TTACATCAATAAGTGGGGC :  TACATCAATAAGTGGGGCA
TTTGGAACGAGAAAGAGTG :  TTGGAACGAGAAAGAGTGC
GGAGATTTGTCCCTGAACG :  GAGATTTGTCCCTGAACGC
ACAGTTTCAAAGGATCGCT :  CAGTTTCAAAGGATCGCTG
TGTTACCTGTCTCACAAGT :  GTTACCTGTCTCACAAGTT
GCATAATGGTCATACTCAG :  CATAATGGTCATACTCAGC
ACCCGCTAATCGCGTTTAA :  CCCGCTAATCGCGTTTAAC
TTAATAGCGTTACGGTTTA :  TAATAGCGTTACGGTTTAT
ATCATCGCCCAATCGCGTA :  TCATCGCCCAATCGCGTAG
AGTGTGCGTCTTTGCTGGC :  GTGTGCGTCTTTGCTGGCG
TGTTTATACGCCGATGAGG :  GTTTATACGCCGATGAGGT
CCTCGGTGTCTCGCGTACA :  CTCGGTGTCTCGCGTACAA
GCTCGTCGGCGAAGTAATA :  CTCGTCGGCGAAGTAATAA
CGCGCGACTCACGTTAATA :  GCGCGACTCACGTTAATAG
CATAATGGTCATACTCAGC :  ATAATGGTCATACTCAGCT
CGGTGCCGAATGCATTTTA :  GGTGCCGAATGCATTTTAT
CGTTCTCACGTGTTCGAGA :  GTTCTCACGTGTTCGAGAT
GCATCGGCCTTGTGGCCTT :  CATCGGCCTTGTGGCCTTA
CAAGGTTCTCCTCAGCTTA :  AAGGTTCTCCTCAGCTTAG
TCAGAGCATTAGAAGGTGG :  CAGAGCATTAGAAGGTGGC
TGGTTTGCAGTATGATGCT :  GGTTTGCAGTATGATGCTT
AAAGGGGCTATTATGATTA :  AAGGGGCTATTATGATTAC
ACCAGAAGGCATAAACTCC :  CCAGAAGGCATAAACTCCC
CCAATGATTGTGCGGTGTA :  CAATGATTGTGCGGTGTAT
GTACATCCTTGGAGATTTG :  TACATCCTTGGAGATTTGA
CTTGAGTTGAAGTGGACAC :  TTGAGTTGAAGTGGACACG
TTACGGTTTATCAGGAGTG :  TACGGTTTATCAGGAGTGA
ACGGGTAGCGGGGGACCAG :  CGGGTAGCGGGGGACCAGA
TTTCAAAGGATCGCTGTTC :  TTCAAAGGATCGCTGTTCG
GCTAAGGATCCGCAATCAT :  CTAAGGATCCGCAATCATC
AGCTGTTTATACGCCGATG :  GCTGTTTATACGCCGATGA
TGGTTCAGACACCTCAGTC :  GGTTCAGACACCTCAGTCA
GGTCATACTCAGCTTGAGT :  GTCATACTCAGCTTGAGTG
GAATTTGGAACGAGAATCT :  AATTTGGAACGAGAATCTA
CTACCTACGAAGCCATCCA :  TACCTACGAAGCCATCCAG
TAATCAGGTGTTAGATTCA :  AATCAGGTGTTAGATTCAG
AATGCCACCACTCGGTACG :  ATGCCACCACTCGGTACGA
CGAAAGACACTGTCTGGTA :  GAAAGACACTGTCTGGTAA
AGCCGCCGATGAAGGCTTG :  GCCGCCGATGAAGGCTTGC
CAGTCACCCGATGACCGGG :  AGTCACCCGATGACCGGGG
AAGTTCTGTACCTACCTAC :  AGTTCTGTACCTACCTACG
GAGAAAGAGTGCCCAGTGA :  AGAAAGAGTGCCCAGTGAC
CAAAAGCTGTGTGGTATTG :  AAAAGCTGTGTGGTATTGC
TTGCTCCACATGCGTACGC :  TGCTCCACATGCGTACGCG
CTCGGCCTTTCCTCCGGGC :  TCGGCCTTTCCTCCGGGCT
TATCAGGAGTGACCTAATG :  ATCAGGAGTGACCTAATGC
AAGTGGGGCAAACGTCATA :  AGTGGGGCAAACGTCATAT
GCGTACAAGCAGGCTGGGT :  CGTACAAGCAGGCTGGGTA
ATACCAGTGGAATTTGGAA :  TACCAGTGGAATTTGGAAC
GGATCCGCAATCATCGCCC :  GATCCGCAATCATCGCCCA
GCAGCGCGCAGGTCCCTTC :  CAGCGCGCAGGTCCCTTCG
TTGTAGTTCACCCTAGGGG :  TGTAGTTCACCCTAGGGGA
CTAGGACAAAATAGTAGGC :  TAGGACAAAATAGTAGGCC
AAAGACACTGTCTGGTAAC :  AAGACACTGTCTGGTAACA
CCGCCGATGAAGGCTTGCC :  CGCCGATGAAGGCTTGCCT
TATGATGCTTATTCCAGTG :  ATGATGCTTATTCCAGTGT
CTCAAGGTTCTCCTCAGCT :  TCAAGGTTCTCCTCAGCTT
ACGGTTTATCAGGAGTGAC :  CGGTTTATCAGGAGTGACC
GCGACTCACGTTAATAGCG :  CGACTCACGTTAATAGCGT
GGTTTGCAGTATGATGCTT :  GTTTGCAGTATGATGCTTA
TCAGGAGTGACCTAATGCG :  CAGGAGTGACCTAATGCGG
GCTCCACATGCGTACGCGT :  CTCCACATGCGTACGCGTC
CACGTGTTCGAGATCAACT :  ACGTGTTCGAGATCAACTG
TAACTCCCACGTGTTATCA :  AACTCCCACGTGTTATCAA
TTTCCTCCGGGCTCAAGAG :  TTCCTCCGGGCTCAAGAGA
TGGAACGAGAATCTATGGT :  GGAACGAGAATCTATGGTT
AGTTTCAAAGGATCGCTGT :  GTTTCAAAGGATCGCTGTT
CGTCTTGAGTTGAAGTGGA :  GTCTTGAGTTGAAGTGGAC
ATTGTGCGGTGTATGATTA :  TTGTGCGGTGTATGATTAA
CCGCCCGCAAGATGTCCAC :  CGCCCGCAAGATGTCCACG
GGATCGTTAAAGGGGCTAT :  GATCGTTAAAGGGGCTATT
ATATACTACTAGCATGCTG :  TATACTACTAGCATGCTGC
TGGACACGATGGACCATTT :  GGACACGATGGACCATTTT
ACAATTTCGTTCTCACGTG :  CAATTTCGTTCTCACGTGT
AATGGTGCACACCCGTAGA :  ATGGTGCACACCCGTAGAT
TACAAGCAGGCTGGGTACA :  ACAAGCAGGCTGGGTACAA
CGCAGGTCCCTTCGCATCG :  GCAGGTCCCTTCGCATCGA
GGCGCTAAGGATCCGCAAT :  GCGCTAAGGATCCGCAATC
CCGACAAACGATACCAGTG :  CGACAAACGATACCAGTGG
ACTGATTAGCTGTTTATAC :  CTGATTAGCTGTTTATACG
CGTCTGTTTGTTGAGGTGC :  GTCTGTTTGTTGAGGTGCT
CGTAGATACTACAAGTTCT :  GTAGATACTACAAGTTCTG
AAGTTTCATGTCTAGGCGC :  AGTTTCATGTCTAGGCGCT
TACCTGTCTCACAAGTTCT :  ACCTGTCTCACAAGTTCTG
TATTGCTCCACATGCGTAC :  ATTGCTCCACATGCGTACG
AATGGCTCGGCCTTTCCTC :  ATGGCTCGGCCTTTCCTCC
AACGTCATATCCGGTGCAT :  ACGTCATATCCGGTGCATG
CCGTGCCAATGATTGTGCG :  CGTGCCAATGATTGTGCGG
ATTTTTTTCAAGGTTGGCC :  TTTTTTTCAAGGTTGGCCA
GTGCCCAGTGACAAGCCTC :  TGCCCAGTGACAAGCCTCA
CGCGCCTCCCCCTCCGCCC :  GCGCCTCCCCCTCCGCCCG
GCGGGGGACCAGAAGGCAT :  CGGGGGACCAGAAGGCATA
CCGATGAAGGCTTGCCTCG :  CGATGAAGGCTTGCCTCGG
GTACTACGAGTTGTAGTCA :  TACTACGAGTTGTAGTCAA
TCGCCTGGTCTTGCAGTTG :  CGCCTGGTCTTGCAGTTGT
ACCAGTTGCGCAGCCCAGT :  CCAGTTGCGCAGCCCAGTG
TTCCAGCTTGGATTTGATG :  TCCAGCTTGGATTTGATGG
AACTCCCACGTGTTATCAA :  ACTCCCACGTGTTATCAAT
GTTCGGCCTGCCGAGTTCC :  TTCGGCCTGCCGAGTTCCA
ATCATCCGACTCTTATGGG :  TCATCCGACTCTTATGGGC
GCAGGCACCTTGACGAGAC :  CAGGCACCTTGACGAGACC
AACTGCATGACTGCGTTTA :  ACTGCATGACTGCGTTTAC
TGAGTGTATTTTTTTCAAG :  GAGTGTATTTTTTTCAAGG
CAATGGTGATAATAAGCAC :  AATGGTGATAATAAGCACG
GTTGAGGTGCTTAAGAGCG :  TTGAGGTGCTTAAGAGCGC
TTCTCCTCAGCTTAGGAGT :  TCTCCTCAGCTTAGGAGTA
GTCCCTTCGCATCGACTGA :  TCCCTTCGCATCGACTGAT
GAAGCTCTCAAAGCCGCAC :  AAGCTCTCAAAGCCGCACC
GGCTTGCCTCGGTGTCTCG :  GCTTGCCTCGGTGTCTCGC
AATCAGGTGTTAGATTCAG :  ATCAGGTGTTAGATTCAGT
TCCTCCGGGCTCAAGAGAG :  CCTCCGGGCTCAAGAGAGC
AATAGTAGGCCAGGCTTAA :  ATAGTAGGCCAGGCTTAAC
TACCTACCTACGAAGCCAT :  ACCTACCTACGAAGCCATC
GTATGATTAACTCACGATA :  TATGATTAACTCACGATAG
ACCAAAAGCTGTGTGGTAT :  CCAAAAGCTGTGTGGTATT
TCCGGTGCATGACAATGCA :  CCGGTGCATGACAATGCAT
TAGCGGGGGACCAGAAGGC :  AGCGGGGGACCAGAAGGCA
TTTAACCCCCGACGTTGGC :  TTAACCCCCGACGTTGGCG
AGAAGGCATAAACTCCCCG :  GAAGGCATAAACTCCCCGG
CATTGCATCGGCCTTGTGG :  ATTGCATCGGCCTTGTGGC
TGTCAATATTCAGCGAAAT :  GTCAATATTCAGCGAAATT
TACGAGTTGTAGTCAAGAG :  ACGAGTTGTAGTCAAGAGA
CAACCTGAGCTATCCCTCG :  AACCTGAGCTATCCCTCGC
TGGCATTAGTTGTTACCTG :  GGCATTAGTTGTTACCTGT
TAAAGGGGCTATTATGATT :  AAAGGGGCTATTATGATTA
GGAACGATCATTGCATCGG :  GAACGATCATTGCATCGGC
TCTCACGTGTTCGAGATCA :  CTCACGTGTTCGAGATCAA
GCCTTGTGGCCTTATCTAG :  CCTTGTGGCCTTATCTAGA
GTAGCGGGGGACCAGAAGG :  TAGCGGGGGACCAGAAGGC
ACAAGTTCTGTACCTACCA :  CAAGTTCTGTACCTACCAG
TGAGCCGCCGATGAAGGCT :  GAGCCGCCGATGAAGGCTT
CTTGCAGTTGTCAATATTC :  TTGCAGTTGTCAATATTCA
GCTTGGATTTGATGGGTGT :  CTTGGATTTGATGGGTGTG
CCAAAATCGTCTTGAGTTG :  CAAAATCGTCTTGAGTTGA
CGAGAAAGAGTGCCCAGTG :  GAGAAAGAGTGCCCAGTGA
TGTATGATTAACTCACGAT :  GTATGATTAACTCACGATA
GTGAACGGTGCCGAATGCA :  TGAACGGTGCCGAATGCAT
CTAGGGGAGTGAGCGTGAA :  TAGGGGAGTGAGCGTGAAC
TATTCCAGTGTGCGTCTTT :  ATTCCAGTGTGCGTCTTTG
GGAATTTGGAACGAGAAAG :  GAATTTGGAACGAGAAAGA
CCTGAGCTATCCCTCGCGC :  CTGAGCTATCCCTCGCGCG
GATTAACTCACGATAGTCG :  ATTAACTCACGATAGTCGA
GATTCAGTGCAATGGTGAT :  ATTCAGTGCAATGGTGATA
GAGAGCCCGATCCAAGACA :  AGAGCCCGATCCAAGACAA
CATTAGTTGTTACCTGTCT :  ATTAGTTGTTACCTGTCTC
ATCAGGTGTTAGATTCAGT :  TCAGGTGTTAGATTCAGTC
TCCTTGAGATGGGATCGGT :  CCTTGAGATGGGATCGGTA
ATTTTCACACCAATTCCGT :  TTTTCACACCAATTCCGTT
CACGATGGACCATTTTCAC :  ACGATGGACCATTTTCACA
TGGCAGCTCGGTCTCCATG :  GGCAGCTCGGTCTCCATGC
TCATCCGACTCTTATGGGC :  CATCCGACTCTTATGGGCG
AAAGCCTTTTGTAGTTCAC :  AAGCCTTTTGTAGTTCACC
CGTGAGCCGCCGATGAAGG :  GTGAGCCGCCGATGAAGGC
TCGGCCTTTCCTCCGGGCT :  CGGCCTTTCCTCCGGGCTC
GGACCTTTAACCCCCGACG :  GACCTTTAACCCCCGACGT
ATACTCAGCTTGAGTGTAT :  TACTCAGCTTGAGTGTATT
TTGTCCCTGAACGCTGCAT :  TGTCCCTGAACGCTGCATC
CGCCCAATCGCGTAGACTT :  GCCCAATCGCGTAGACTTA
GCTGTGTGGTATTGCTCCA :  CTGTGTGGTATTGCTCCAC
TCACACGGTGCGTGATACA :  CACACGGTGCGTGATACAC
CAGAGCATTAGAAGGTGGC :  AGAGCATTAGAAGGTGGCT
GTATCCAACCAACAGGGCA :  TATCCAACCAACAGGGCAG
TCGCGCGACTCACGTTAAT :  CGCGCGACTCACGTTAATA
CGGCGGGCAACCTGAGCTA :  GGCGGGCAACCTGAGCTAT
ACAAACGATACCAGTGGAA :  CAAACGATACCAGTGGAAT
GACTGCGTTTACCCTTTCC :  ACTGCGTTTACCCTTTCCG
TCGGCCTGCCGAGTTCCAG :  CGGCCTGCCGAGTTCCAGC
CGCGGAGATTTGTCCCTGA :  GCGGAGATTTGTCCCTGAA
ACCCCCGACGTTGGCGAAG :  CCCCCGACGTTGGCGAAGG
TTGCACTACCCACCCGATA :  TGCACTACCCACCCGATAT
TTGCAGTTGTCAATATTCA :  TGCAGTTGTCAATATTCAG
CAGTTTCAAAGGATCGCTG :  AGTTTCAAAGGATCGCTGT
CTGCTCGATCCTGTTAAAA :  TGCTCGATCCTGTTAAAAA
CTGGTACTGCTGGCCGTGG :  TGGTACTGCTGGCCGTGGC
AGTGGCGGATTGAGCGCGG :  GTGGCGGATTGAGCGCGGA
ATATACAGTTTCAAAGGAT :  TATACAGTTTCAAAGGATC
GCCTTATCTAGACCGTTGA :  CCTTATCTAGACCGTTGAA
AGATGGGATCGGTAGAATA :  GATGGGATCGGTAGAATAA
AGCCCAGTGGAATTTGGAA :  GCCCAGTGGAATTTGGAAC
AGGATCCGCAATCATCGCC :  GGATCCGCAATCATCGCCC
TGGGACCTTTAACCCCCGA :  GGGACCTTTAACCCCCGAC
CAGGCTGGGTACAATTTCG :  AGGCTGGGTACAATTTCGT
TTCACACGGTGCGTGATAC :  TCACACGGTGCGTGATACA
GTGCGTGATACACGCAGGC :  TGCGTGATACACGCAGGCA
GTAGGTATCCAACCAACAG :  TAGGTATCCAACCAACAGG
CTGGCTATCAGTATTCGCC :  TGGCTATCAGTATTCGCCG
GACGTGAATAGAACTCCTT :  ACGTGAATAGAACTCCTTG
GTGCAGCGAGTGTGTATCG :  TGCAGCGAGTGTGTATCGT
CTATCAGTATTCGCCGGAA :  TATCAGTATTCGCCGGAAA
CTTAACTTGACTACCACTT :  TTAACTTGACTACCACTTG
GTTCTGTACCTACCCGGTA :  TTCTGTACCTACCCGGTAT
GACTCACGTTAATAGCGTT :  ACTCACGTTAATAGCGTTA
GATACACGCAGGCACCTTG :  ATACACGCAGGCACCTTGA
CAGTCACACCGTGCCAATG :  AGTCACACCGTGCCAATGA
TACCCTTTCCGGGTAGCTG :  ACCCTTTCCGGGTAGCTGA
CTCCGGGCTCAAGAGAGCG :  TCCGGGCTCAAGAGAGCGC
GGGCTCATATCATCCGACT :  GGCTCATATCATCCGACTC
TAAGAGCGCCCGTACTACG :  AAGAGCGCCCGTACTACGA
ACGCTGCATCATAGTGAGG :  CGCTGCATCATAGTGAGGG
CTTATTCCAGTGTGCGTCT :  TTATTCCAGTGTGCGTCTT
CAATGCATAATGGTCATAC :  AATGCATAATGGTCATACT
CTTGTGGGACCTTTAACCC :  TTGTGGGACCTTTAACCCC
AATGGTGATAATAAGCACG :  ATGGTGATAATAAGCACGG
CACCAATTCCGTTGTAGTC :  ACCAATTCCGTTGTAGTCC
GGCTCTAACAAGTTCTGTA :  GCTCTAACAAGTTCTGTAC
AAGGCTTGCCTCGGTGTCT :  AGGCTTGCCTCGGTGTCTC
GCTCGGCCTTTCCTCCGGG :  CTCGGCCTTTCCTCCGGGC
GACAATGCATAATGGTCAT :  ACAATGCATAATGGTCATA
GGTTGTCCGTGAGCCGCCG :  GTTGTCCGTGAGCCGCCGA
ATAGCGTTACGGTTTATCA :  TAGCGTTACGGTTTATCAG
GACCATGGTTTGCAGTATG :  ACCATGGTTTGCAGTATGA
CCGCACCCGCGCCTCCCCC :  CGCACCCGCGCCTCCCCCT
CCCGTAGATACTACAAGTT :  CCGTAGATACTACAAGTTC
GTTCTGTACCTACCTACGA :  TTCTGTACCTACCTACGAA
GGGGCTATTATGATTACAT :  GGGCTATTATGATTACATC
AACGAGAATCTATGGTTTC :  ACGAGAATCTATGGTTTCT
AAGACACTGTCTGGTAACA :  AGACACTGTCTGGTAACAA
CAAAGCCGCACCCGCGCCT :  AAAGCCGCACCCGCGCCTC
TTAGCTGTTTATACGCCGA :  TAGCTGTTTATACGCCGAT
CATGCTGCAACTCGGCGCG :  ATGCTGCAACTCGGCGCGG
GATTAGCTGTTTATACGCC :  ATTAGCTGTTTATACGCCG
AAATCGTCTTGAGTTGAAG :  AATCGTCTTGAGTTGAAGT
CGGTGTCTCGCGTACAAGC :  GGTGTCTCGCGTACAAGCA
AGGCTTAACTTGACTACCA :  GGCTTAACTTGACTACCAC
TAATAGCGTTACGGTTTAT :  AATAGCGTTACGGTTTATC
CGTGGAATATACTACTAGC :  GTGGAATATACTACTAGCA
CCTTTAACCCCCGACGTTG :  CTTTAACCCCCGACGTTGG
ACCTACCAGTTGCGCAGCC :  CCTACCAGTTGCGCAGCCC
GAGCCGCCGATGAAGGCTT :  AGCCGCCGATGAAGGCTTG
GTGTTAGATTCAGTCACCC :  TGTTAGATTCAGTCACCCG
ACACATACTAGGACAAAAT :  CACATACTAGGACAAAATA
ATCGCGTAGACTTACGTGG :  TCGCGTAGACTTACGTGGA
AATCGCGTTTAACGGCTTT :  ATCGCGTTTAACGGCTTTG
GTCAATATTCAGCGAAATT :  TCAATATTCAGCGAAATTC
TATTCAGCGAAATTCAGGG :  ATTCAGCGAAATTCAGGGG
CCCCGGGCGGCGGGCAACC :  CCCGGGCGGCGGGCAACCT
CGACTGATTAGCTGTTTAT :  GACTGATTAGCTGTTTATA
TCCCTTCGCATCGACTGAT :  CCCTTCGCATCGACTGATT
AAGTGGACACGATGGACCA :  AGTGGACACGATGGACCAT
AGAAGGTGGCTCGTCGGCG :  GAAGGTGGCTCGTCGGCGA
TCTGTACCTACCCGGTATA :  CTGTACCTACCCGGTATAC
AGACCGTGGTATCGCCTGG :  GACCGTGGTATCGCCTGGT
CACCCTAGGGGAGTGAGCG :  ACCCTAGGGGAGTGAGCGT
AGTCACCCGATGACCGGGG :  GTCACCCGATGACCGGGGA
GGTGTCTCGCGTACAAGCA :  GTGTCTCGCGTACAAGCAG
CCGTTGTAGTCCAATACGT :  CGTTGTAGTCCAATACGTA
ATAAGCACGGGTAGCGGGG :  TAAGCACGGGTAGCGGGGG
GTTGAAGTGGACACGATGG :  TTGAAGTGGACACGATGGA
CCACCACTCGGTACGAAAG :  CACCACTCGGTACGAAAGA
CTACAAGTTCTGTACCTAC :  TACAAGTTCTGTACCTACC
TGGGATCGGTAGAATAACT :  GGGATCGGTAGAATAACTC
AGGTGTGCAGCGAGTGTGT :  GGTGTGCAGCGAGTGTGTA
TGCAATGGTGATAATAAGC :  GCAATGGTGATAATAAGCA
GCGTACGCGTCTGTTTGTT :  CGTACGCGTCTGTTTGTTG
CTACTAGCATGCTGCAACT :  TACTAGCATGCTGCAACTC
TAGTGGCGGATTGAGCGCG :  AGTGGCGGATTGAGCGCGG
GAGACCGTGGTATCGCCTG :  AGACCGTGGTATCGCCTGG
GAGATTTGAGGTGGATTCA :  AGATTTGAGGTGGATTCAG
CCTCGGCCAACCAAAAGCT :  CTCGGCCAACCAAAAGCTG
TTATCAATGCCACCACTCG :  TATCAATGCCACCACTCGG
AAATAATCAGGTGTTAGAT :  AATAATCAGGTGTTAGATT
CACGTGTTATCAATGCCAC :  ACGTGTTATCAATGCCACC
GCTTGCCTCGGTGTCTCGC :  CTTGCCTCGGTGTCTCGCG
AGGATCGCTGTTCGGCCTG :  GGATCGCTGTTCGGCCTGC
CACGGGTAGCGGGGGACCA :  ACGGGTAGCGGGGGACCAG
CGGTATACGCGCCAGTGGA :  GGTATACGCGCCAGTGGAA
TCAATAAGTGGGGCAAACG :  CAATAAGTGGGGCAAACGT
TATACGCGCCAGTGGAATT :  ATACGCGCCAGTGGAATTT
GATTACATCAATAAGTGGG :  ATTACATCAATAAGTGGGG
CCTCCAGGTGGCAGCTCGG :  CTCCAGGTGGCAGCTCGGT
GTTGAACCGGATCGTTAAA :  TTGAACCGGATCGTTAAAG
CTGTCTGGTAACAAAGCCT :  TGTCTGGTAACAAAGCCTT
ACTCCTTGAGATGGGATCG :  CTCCTTGAGATGGGATCGG
GAACGAGAAAGAGTGCCCA :  AACGAGAAAGAGTGCCCAG
GACCTTTAACCCCCGACGT :  ACCTTTAACCCCCGACGTT
TTGAGATGGGATCGGTAGA :  TGAGATGGGATCGGTAGAA
TATGATTAACTCACGATAG :  ATGATTAACTCACGATAGT
CCCTTTCCGGGTAGCTGAC :  CCTTTCCGGGTAGCTGACC
TTGAGGTGCTTAAGAGCGC :  TGAGGTGCTTAAGAGCGCC
AGGTTCTCCTCAGCTTAGG :  GGTTCTCCTCAGCTTAGGA
GTGATACACGCAGGCACCT :  TGATACACGCAGGCACCTT
GTTCAGACACCTCAGTCAC :  TTCAGACACCTCAGTCACA
AAGGGGCTATTATGATTAC :  AGGGGCTATTATGATTACA
TTACCTGTCTCACAAGTTC :  TACCTGTCTCACAAGTTCT
CTATTAAAGTAGACCCCTG :  TATTAAAGTAGACCCCTGA
AGGCCTGGATTCACACGGT :  GGCCTGGATTCACACGGTG
GCTGTTCGGCCTGCCGAGT :  CTGTTCGGCCTGCCGAGTT
CCGTACTACGAGTTGTAGT :  CGTACTACGAGTTGTAGTC
GTCACCCGATGACCGGGGA :  TCACCCGATGACCGGGGAC
CCGGGCTCAAGAGAGCGCA :  CGGGCTCAAGAGAGCGCAG
ACCATTTTCACACCAATTC :  CCATTTTCACACCAATTCC
CATTTTCACACCAATTCCG :  ATTTTCACACCAATTCCGT
TTGTAGTCCAATACGTATG :  TGTAGTCCAATACGTATGG
CCTCCCCCTCCGCCCGCAA :  CTCCCCCTCCGCCCGCAAG
TAGTCCAATACGTATGGTT :  AGTCCAATACGTATGGTTC
GTTACCTGTCTCACAAGTT :  TTACCTGTCTCACAAGTTC
TCGGCCAACCAAAAGCTGT :  CGGCCAACCAAAAGCTGTG
CCGAATGCATTTTATGAGG :  CGAATGCATTTTATGAGGC
TGCAGTATGATGCTTATTC :  GCAGTATGATGCTTATTCC
TGACCACGACCATGGTTTG :  GACCACGACCATGGTTTGC
GCTTAACTTGACTACCACT :  CTTAACTTGACTACCACTT
AAGCCATCCAGTGGAATTT :  AGCCATCCAGTGGAATTTG
CCCACCCGATATACAGTTT :  CCACCCGATATACAGTTTC
ACCGACAAACGATACCAGT :  CCGACAAACGATACCAGTG
CCACTTGTGGGACCTTTAA :  CACTTGTGGGACCTTTAAC
GCTGGCTATCAGTATTCGC :  CTGGCTATCAGTATTCGCC
TCTGTTTGTTGAGGTGCTT :  CTGTTTGTTGAGGTGCTTA
CGCGTTTAACGGCTTTGCA :  GCGTTTAACGGCTTTGCAC
CAAGTTCTGTACCTACCCG :  AAGTTCTGTACCTACCCGG
TGTACCTACCAGTTGCGCA :  GTACCTACCAGTTGCGCAG
TTGCTGGCGTTTAGTGGCG :  TGCTGGCGTTTAGTGGCGG
TTGAGTTGAAGTGGACACG :  TGAGTTGAAGTGGACACGA
GCTGGCGTTTAGTGGCGGA :  CTGGCGTTTAGTGGCGGAT
TGGGTACAATTTCGTTCTC :  GGGTACAATTTCGTTCTCA
AACAAAGCCTTTTGTAGTT :  ACAAAGCCTTTTGTAGTTC
CCGTGTTAGAGAACTGCAT :  CGTGTTAGAGAACTGCATG
CGATATACAGTTTCAAAGG :  GATATACAGTTTCAAAGGA
GGCCTGAACTGGTACTGCT :  GCCTGAACTGGTACTGCTG
AGCGCAGCGCGCAGGTCCC :  GCGCAGCGCGCAGGTCCCT
GTTGTAGTCCAATACGTAT :  TTGTAGTCCAATACGTATG
GTGTGGTATTGCTCCACAT :  TGTGGTATTGCTCCACATG
TGATGGGTGTGGTATGCCT :  GATGGGTGTGGTATGCCTC
TATGATTACATCAATAAGT :  ATGATTACATCAATAAGTG
CACTACCCACCCGATATAC :  ACTACCCACCCGATATACA
GCCGATGAGGTGGTACATC :  CCGATGAGGTGGTACATCC
AGGTGGCAGCTCGGTCTCC :  GGTGGCAGCTCGGTCTCCA
ATCAACTGCTCGATCCTGT :  TCAACTGCTCGATCCTGTT
CTTTCCGGGTAGCTGACCC :  TTTCCGGGTAGCTGACCCT
GTACCTACCGACAAACGAT :  TACCTACCGACAAACGATA
TTTGCACTACCCACCCGAT :  TTGCACTACCCACCCGATA
GCAGGTCCCTTCGCATCGA :  CAGGTCCCTTCGCATCGAC
TGATGTGCGAGGTGTGCAG :  GATGTGCGAGGTGTGCAGC
TGCTCGATCCTGTTAAAAA :  GCTCGATCCTGTTAAAAAG
ATTACATCAATAAGTGGGG :  TTACATCAATAAGTGGGGC
GAACTGGTACTGCTGGCCG :  AACTGGTACTGCTGGCCGT
CTCAGCTTGAGTGTATTTT :  TCAGCTTGAGTGTATTTTT
AGTAGGTATCCAACCAACA :  GTAGGTATCCAACCAACAG
CGAAGGGTCTGAAGACACT :  GAAGGGTCTGAAGACACTA
CGCAATCATCGCCCAATCG :  GCAATCATCGCCCAATCGC
GCTGGGTACAATTTCGTTC :  CTGGGTACAATTTCGTTCT
GCTCATATCATCCGACTCT :  CTCATATCATCCGACTCTT
TTCAGTGCAATGGTGATAA :  TCAGTGCAATGGTGATAAT
AGCAGGCTGGGTACAATTT :  GCAGGCTGGGTACAATTTC
CGCCGGAAATGGCTCGGCC :  GCCGGAAATGGCTCGGCCT
ATTTGTCCCTGAACGCTGC :  TTTGTCCCTGAACGCTGCA
TTTTCACACCAATTCCGTT :  TTTCACACCAATTCCGTTG
CAAAATAGTAGGCCAGGCT :  AAAATAGTAGGCCAGGCTT
GGCGAAGTAATAAAAAAGA :  GCGAAGTAATAAAAAAGAC
GTGTGGTATGCCTCGGCCA :  TGTGGTATGCCTCGGCCAA
CAGCGAAATTCAGGGGCAC :  AGCGAAATTCAGGGGCACC
AATTTGGAACGAGAAAGAG :  ATTTGGAACGAGAAAGAGT
CCTACGAAGCCATCCAGTG :  CTACGAAGCCATCCAGTGG
CAATCATCGCCCAATCGCG :  AATCATCGCCCAATCGCGT
TTATCAGGAGTGACCTAAT :  TATCAGGAGTGACCTAATG
CCCCTCCGCCCGCAAGATG :  CCCTCCGCCCGCAAGATGT
TCATTGCATCGGCCTTGTG :  CATTGCATCGGCCTTGTGG
ACCCCTGACCACGACCATG :  CCCCTGACCACGACCATGG
CGTGTTCGAGATCAACTGC :  GTGTTCGAGATCAACTGCT
TGGTCATACTCAGCTTGAG :  GGTCATACTCAGCTTGAGT
GTGACAAGCCTCAGAGCAT :  TGACAAGCCTCAGAGCATT
TTAACTCACGATAGTCGAA :  TAACTCACGATAGTCGAAG
CGTGATACACGCAGGCACC :  GTGATACACGCAGGCACCT
TGGCGAAGGGTCTGAAGAC :  GGCGAAGGGTCTGAAGACA
CGTTTGGACACGTAGAAGC :  GTTTGGACACGTAGAAGCT
CGATGGACCATTTTCACAC :  GATGGACCATTTTCACACC
AATTTGGAACGAGAATCTA :  ATTTGGAACGAGAATCTAT
ATTGAGCGCGGAGATTTGT :  TTGAGCGCGGAGATTTGTC
AGGGGGCGCTAAGGATCCG :  GGGGGCGCTAAGGATCCGC
CCCGCTAATCGCGTTTAAC :  CCGCTAATCGCGTTTAACG
ACAAAATAGTAGGCCAGGC :  CAAAATAGTAGGCCAGGCT
TACTAGCATGCTGCAACTC :  ACTAGCATGCTGCAACTCG
CCAGTGTGCGTCTTTGCTG :  CAGTGTGCGTCTTTGCTGG
ATAAGTGGGGCAAACGTCA :  TAAGTGGGGCAAACGTCAT
ACGTGGAATATACTACTAG :  CGTGGAATATACTACTAGC
TACGCGTCTGTTTGTTGAG :  ACGCGTCTGTTTGTTGAGG
TGTTAGATTCAGTCACCCG :  GTTAGATTCAGTCACCCGA
GAGTGTGTATCGTTTGGAC :  AGTGTGTATCGTTTGGACA
AGAACTGCATGACTGCGTT :  GAACTGCATGACTGCGTTT
GTTACGGTTTATCAGGAGT :  TTACGGTTTATCAGGAGTG
CATCATAGTGAGGGGGCTC :  ATCATAGTGAGGGGGCTCA
TTCGAGATCAACTGCTCGA :  TCGAGATCAACTGCTCGAT
CCGTTGAACCGGATCGTTA :  CGTTGAACCGGATCGTTAA
GCGGCAAGTACAAAGGCAA :  CGGCAAGTACAAAGGCAAG
TTGGCGAAGGGTCTGAAGA :  TGGCGAAGGGTCTGAAGAC
AATCGCGTAGACTTACGTG :  ATCGCGTAGACTTACGTGG
TTCGTTCTCACGTGTTCGA :  TCGTTCTCACGTGTTCGAG
GATCCAAGACAATGGCCTG :  ATCCAAGACAATGGCCTGA
CGGTGCGTGATACACGCAG :  GGTGCGTGATACACGCAGG
GCTCTAACAAGTTCTGTAC :  CTCTAACAAGTTCTGTACC
CATAGTGAGGGGGCTCATA :  ATAGTGAGGGGGCTCATAT
GCCTCAGAGCATTAGAAGG :  CCTCAGAGCATTAGAAGGT
AAAAGCCCGTGATGTGCGA :  AAAGCCCGTGATGTGCGAG
TACCGACAAACGATACCAG :  ACCGACAAACGATACCAGT
AATTTGGAACGAATCCTCC :  ATTTGGAACGAATCCTCCA
TATTATGATTACATCAATA :  ATTATGATTACATCAATAA
CATACTAGGACAAAATAGT :  ATACTAGGACAAAATAGTA
ACAATGGCCTGAACTGGTA :  CAATGGCCTGAACTGGTAC
GAATAGAACTCCTTGAGAT :  AATAGAACTCCTTGAGATG
CGTGATGTGCGAGGTGTGC :  GTGATGTGCGAGGTGTGCA
GTAGGCCAGGCTTAACTTG :  TAGGCCAGGCTTAACTTGA
GGTACTGCTGGCCGTGGCA :  GTACTGCTGGCCGTGGCAT
GTATGATGCTTATTCCAGT :  TATGATGCTTATTCCAGTG
CAATGATTGTGCGGTGTAT :  AATGATTGTGCGGTGTATG
TGTGTATCGTTTGGACACG :  GTGTATCGTTTGGACACGT
GTTAATAGCGTTACGGTTT :  TTAATAGCGTTACGGTTTA
CTAAGGATCCGCAATCATC :  TAAGGATCCGCAATCATCG
ACCCGATATACAGTTTCAA :  CCCGATATACAGTTTCAAA
ATTCAGTCACCCGATGACC :  TTCAGTCACCCGATGACCG
ATATCCGGTGCATGACAAT :  TATCCGGTGCATGACAATG
CCTTGACGAGACCGTGGTA :  CTTGACGAGACCGTGGTAT
GGCAACCTGAGCTATCCCT :  GCAACCTGAGCTATCCCTC
GGTATCCAACCAACAGGGC :  GTATCCAACCAACAGGGCA
AGTGAGGGGGCTCATATCA :  GTGAGGGGGCTCATATCAT
GTGACCTAATGCGGACAAG :  TGACCTAATGCGGACAAGT
CCGCGCCTCCCCCTCCGCC :  CGCGCCTCCCCCTCCGCCC
CTACCACTTGTGGGACCTT :  TACCACTTGTGGGACCTTT
GTTCTGTACCTACCAGTTG :  TTCTGTACCTACCAGTTGC
TTAGAGAACTGCATGACTG :  TAGAGAACTGCATGACTGC
GATGAGGTGGTACATCCTT :  ATGAGGTGGTACATCCTTG
GAGCGCCCGTACTACGAGT :  AGCGCCCGTACTACGAGTT
GCGTCTTTGCTGGCGTTTA :  CGTCTTTGCTGGCGTTTAG
TATACTACTAGCATGCTGC :  ATACTACTAGCATGCTGCA
ACCCTACTGCGGGCTCTAA :  CCCTACTGCGGGCTCTAAC
GAATATACTACTAGCATGC :  AATATACTACTAGCATGCT
TTTCACACCAATTCCGTTG :  TTCACACCAATTCCGTTGT
GGACCAGAAGGCATAAACT :  GACCAGAAGGCATAAACTC
ACGGTGCGTGATACACGCA :  CGGTGCGTGATACACGCAG
GTGTATTTTTTTCAAGGTT :  TGTATTTTTTTCAAGGTTG
AGGTGGATTCAGTGCAATG :  GGTGGATTCAGTGCAATGG
ACCTGAGCTATCCCTCGCG :  CCTGAGCTATCCCTCGCGC
GGGTCTGAAGACACTATTA :  GGTCTGAAGACACTATTAA
AAGCAGGCTGGGTACAATT :  AGCAGGCTGGGTACAATTT
CTCATATCATCCGACTCTT :  TCATATCATCCGACTCTTA
GGGCAACCTGAGCTATCCC :  GGCAACCTGAGCTATCCCT
GGAACGAGAAAGAGTGCCC :  GAACGAGAAAGAGTGCCCA
ACCGGATCGTTAAAGGGGC :  CCGGATCGTTAAAGGGGCT
CCATGGTTTGCAGTATGAT :  CATGGTTTGCAGTATGATG
AGGTATCCAACCAACAGGG :  GGTATCCAACCAACAGGGC
GGGGGCTCATATCATCCGA :  GGGGCTCATATCATCCGAC
